last_15	first_15	word_break
yrio sanctorum.	Querenti mihi a	0
enti mihi ac di	ligenter perscr	1
e ecclesiae fun	damentum et aug	1
mihi potissimum	martyrium videt	0
 experientia do	cuit quod marty	1
icentissima tor	mentorum toller	1
um in admiratio	nem stuporemque	1
de ad veritatis	hoc est Iesu ch	0
m: conduxerunt.	Quo reperto/ et	0
exquisitissimas	mortes subire: 	0
men ubique pro-	fiterentur non 	1
 ut cum terribi	liora tormenta 	1
nas persecutio-	nes undique com	1
essionem sacrae	fidei prorumpeb	0
e domini nostri	Iesu christi/ p	0
 sit: sui mili-	tes: ac discipu	1
ntes inextimabi	lis sanguinis e	1
daverunt et au-	xerunt: substen	1
sanctissimum su	um nomen: illiu	1
romanus aliique	mundi principes	0
s impresserunt.	Quibus confusus	0
t: et novas ter	ribilesque haer	1
. Ut et per se-	cutiones peiore	1
ntibus in chri-	stianos fierent	1
nctis suis: qui	et scripturis s	0
ationibus: hae-	reses extermina	1
ace: crevit un-	dique mirabilit	1
m non sit stel-	lis ornatum sic	1
is monachis re-	plebantur: ut s	1
admiratus anti-	quus hostis: ac	1
adinvenit. Mun-	di illecebras v	1
nter pacis ocio	suggerebat. Ine	0
 inutilem studi	um suadebat. In	1
principes novas	Interea Phi	0
Interea Phi	lippus rex mace	1
macedonie abiit	in proelium. An	0
um. Anectanabus	autem ascendens	0
latium ut regi-	nam Olympiam co	1
iceret et vide-	ret pulchritudi	1
ius. Hic cum vi	det eam iaculat	1
cor eius in con	cupiscentiam ei	1
t. extendensque	manum suam salu	0
eam dicens. Ave	regina Macedoni	0
. dedignatus ei	dicere domina. 	0
c respondens ei	Olympia dixit. 	0
e magister acce	de propius et s	1
ente autem ipso	interrogavit eu	0
Olympia. Ne est	quin aegyptius 	0
pondit illi ane	ctanabus. Verbu	1
regale dixisti.	quando aegyptio	0
nominasti. Sunt	enim aegyptii s	0
 qui etiam som-	nia solvunt. si	1
strant. volati-	lia intelligunt	1
 aperiunt et co	gnoscunt fata n	1
iam. de his om-	nibus ut prophe	1
gnosco. Hoc au-	tem cum dixisse	1
 eam sensu con-	cupiscibili. Vi	1
lympia quod sic	aspexit eam dix	0
gister quid co-	gitasti me tali	1
iciendo. Respon	dit anectanabus	1
 Recordatus sum	plurima respons	0
orum. Etenim re	sponsum accepi 	1
erem intueri re	ginam. Haec eo 	1
e statim protu-	lit de sinu suo	1
 tabulam aeream	et eburneam mix	0
uro et argento.	tres in se circ	0
ntinentem. Pri-	mus continebat 	1
 intelligentias	duodecim. In te	0
vero sol et lu-	na parebant. Po	1
ec apparebat ca	thena eburnea e	1
protulit septem	splendidissima 	0
 horas exploran	tia. et nativit	1
et septem lapi-	des sculptos et	1
 lapides ad cu-	stodiam hominum	1
titutos. Videns	hoc Olympia dix	0
li. Magister si	vis ut crederem	0
 Dic mihi annum	diem et horam n	0
 regis. Cum hic	dixisset ait re	0
isne aliud a me	audire. Regina 	0
 Volo ut renun-	cies mihi quod 	1
 philippum acci	dere debet. Ref	1
nt enim homines	quod cum venit 	0
 proelio eiciet	me aliamque con	0
uxorem. Cui ane	ctanabus ait. F	1
ulta loquuntur.	sed antequam mu	0
pora elabuntur.	evenit quod dix	0
d tandem te phi	lippus habebit 	1
m. Ad haec regi	na ait. Obsecro	1
gister ut omnem	aperias mihi ve	0
em. Cui anecta-	nabus ait. Unus	1
x potentissimis	diis concubet t	0
 in cunctis pro	speritatibus et	1
tatibus adiuva-	bit. Olympia re	1
dit. Obsecro te	magister ut mih	0
eras quam figu-	ram gerit ille 	1
it anectanabus.	Neque iuvenis n	0
senex et barbam	canis habens or	0
m. Unde si pla-	cet esto illi p	1
ia in nocte vi-	debis eum. et i	1
concubet tecum.	Regina dixit. S	0
c videro non ut	prophetam nec d	0
d ut deum ipsum	adorabo. Statim	0
 anectanabus di	cens. Vale regi	1
ost haec anecta	nabus descenden	1
latio et exiens	continuo castra	0
tis in desertum	locum et evelli	0
erensque eas et	succos illarum 	0
cit incantatio-	nes per diaboli	1
enta. ut in ea-	dem nocte Olymp	1
mpia deum Hamon	concumbentem se	0
et. dicentemque	ei post concubi	0
r concepisti de	fensorem tuum. 	1
autem facto cum	esset Olympia a	0
o excitata con-	vocabat anectan	1
. eique somnium	quod viderat re	0
. Tunc anectana	bus dixit. Si l	1
um mihi dederis	in palatio deum	0
 facie ad faci-	em contemplaber	1
. Nam ille deus	Apientissi	0
Apientissi	mi aegiptii sci	0
ii scientes men	suram terrae. u	1
 terrae. undas-	que maris et ca	1
s et caelestium	ordinem cognosc	0
dinem cognoscen	tes. id est ste	1
t stellarum cur	sum. motum etia	1
irmamenti tradi	derunt etiam un	1
orbi per altitu	dinem et per no	1
am artium magi-	carum. Dicunt e	1
im de Anectana-	bo rege ipsorum	1
fuerit ingenio-	sus de astrolog	1
 et mathematica	eruditus. Quada	0
tem die dum nun	tiatum fuisset 	1
Artarxerses rex	persarum cum va	0
manu hostium su	per eum veniret	1
 movit militiam	neque preparavi	0
tum. sed intra-	vit cubiculum p	1
 sui. et depren	dens concham ae	1
eam plenam aqua	pluviali tenens	0
 in manu virgam	aeream. hic per	0
m incantationem	demones convoca	0
 et per magicas	incantationes i	0
ligebat in ipsa	concha claves n	0
m super eum po-	tentissime veni	1
rant enim prin-	cipes in custod	1
iae positi Ane-	ctabi a confini	1
persarum. Venit	quidam exors di	0
ns. Maxime Ane-	ctabe insurgit 	1
Artarxerses rex	persarum cum mu	0
itudine hostium	et gentilium in	0
. Sunt enim Par	thi. Medi. Pers	1
e. Syrii. Meso-	potamii. Drapes	1
. Phares. Argi-	ri. Caldei. Bac	1
. Confires Hir-	cani atque Agio	1
aliae pluresque	gentes de orien	0
tibus proceden-	tes. Cum haec a	1
set Anectanabus	suspirans dixit	0
odiam quam tibi	condidi bene ob	0
. sed non tamen	sicut princeps 	0
isti. sed sicut	homo timidus Vi	0
s enim non haec	valet in multit	0
uli sed in for-	titudine animor	1
escis quod unus	leo multos cerv	0
in fugam vertit	Et haec dicens 	0
intravit cubicu	lum solus. et f	1
culas aereas in	concha cum aqua	0
plena pluviali.	tenensque in ma	1
rgam palmae. et	respiciens in i	0
cepit totis vi-	ribus incantare	1
idebat qualiter	aegyptii sterne	0
r impetu classi	um Barbarorum. 	0
Statimque muta-	to habitu raden	1
i caput et bar-	bam. et tulit a	1
m quantumcumque	portare potuit.	0
mque erant sibi	necessaria ad a	0
logiam et ad ar	tes magicas exe	1
ndas fugit pro-	pe pelusium de 	1
. Denique veni-	ens aethiopiam 	0
 linea vestimen	ta aegyptius qu	1
opheta intravit	macedoniam sede	0
sque manam gre-	cis coram omnib	1
m videntibus di	vinabat. Aegypt	1
ero ut viderunt	quia Anectanabu	0
on inveniebatur	ad curtum. perr	0
runt ad Serapim	deum illorum ma	0
 rogaverunt eum	ut vera respons	0
 eis de anecta-	nabo rege eorum	1
rapis autem re-	spondit. Anecta	1
abus rex vester	abiit de aegypt	0
ter artarxersem	regem persarum.	0
vos suo imperio	subiugabit. Pos	0
odicum vero tem	pus revertetur 	1
 reiciendo a se	servitutem et u	1
 de inimicis ve	stris subiugand	1
 vobis. Et haec	responsa recipi	0
statim fecerunt	statuam regalem	0
ide nigro in ho	norem Anectanab	1
 scripserunt ad	pedes eius resp	0
 ut in posterum	memoriae mandar	0
ur. Anectanabus	autem mansit ma	0
iae incognitus.	Quomodo Anectan	0
ectanabus ascen	dit palatium ad	1
ad Olympiam re-	ginam.	1
ginam.	in figura draco	0
e veniet. et ex	inde humanam fo	1
m accipiens. et	mea similitudin	0
arebit. Ad haec	Olympia dixit. 	0
t dixisti magi-	ster. recipe ti	1
ulum in palatio	et si veritatem	0
valebis te qua-	si patrem pueri	1
 Et haec dicens	iussit sibi cub	0
 palatio fieri.	Circa autem pri	0
vigiliam noctis	coepit anectana	0
r incantationes	magicas transmu	1
in figuram dra-	conis. et sibil	0
ontra cubiculum	Olympie coepit 	0
volare. Ingres-	susque cubiculu	1
endit in lectum	eius. et coepit	0
culari. et post	oscula cognovit	0
am. Cum autem a	concubitu surre	0
ercussit eam in	utero et dixit.	0
tio sit ultrix.	et nullatenus c	0
ncatur ab homi-	ne. Taliter dec	1
pta Olympia cum	homine tamquam 	0
o concubuit. Ma	ne autem facto 	1
dit anectanabus	de palatio. Reg	0
taque praegnans	erat. Cum autem	0
isset tumescere	venter eius voc	0
ad se anectana-	bum. et dixit i	1
ter volo ut di-	cas mihi quicqu	1
 me faciet Phi-	lippus si redib	1
Cui anectanabus	ait. Noli expav	0
. quia deus Ha-	mon auxiliator 	1
rit. Et his di-	ctis exiit de p	1
ra civitatem in	desertum locum.	0
s herbas tritu-	ravit eas. et t	1
illarum. appre-	hendensque avem	1
oepit super eam	incantare. illa	0
cco herbarum li	niens. Haec tam	1
bat per diaboli	ca figmenta ut 	1
eret regem Phi-	lippum per somn	1
ctumque est ea-	dem nocte appar	1
philippo in som	nio deus Hamon 	1
n concubens cum	Olympia uxore s	0
et post concubi	tum quod videre	1
onsuere et anu-	lo aureo consig	1
t in ipso anulo	erat lapis ubi 	0
ulptum caput le	onis et currus 	1
gladius peracu-	tus. et dixit e	1
 concepisti de-	fensorem tuum. 	1
gens autem phi-	lippus a somno 	1
it hariolum. et	somnium quod vi	0
ntimavit. At il	le hariolus dix	1
lippe non ab ho	mine sed a deo 	1
ua concepit. Ca	put namque leon	1
s solis et gla-	dius acutus tal	1
 exponunt. Quia	qui nasci debet	0
pertinget usque	ad orientem und	0
l egreditur. Et	per gladium acu	0
versae sibi de-	bent subiugari 	1
ugari nationes.	Qualiter Anecta	0
tanabus in figu	ra draconis ant	1
debat philippum	in proelio devi	0
endo et hostes.	Interea Phi	0
Interea Phi	lippus rex pugn	1
pugnavit et vi-	cit. Apparuit e	1
 namque in ipso	proelio draco q	0
cedebat eum. et	inimicos eius p	0
ernebat. Cumque	rediret macedon	0
 obviavit ei O-	lympia et oscul	1
am. Intuens eam	philippus rex e	0
i. Cui te olym-	pia tradidisti.	1
i inquit et non	peccasti. quia 	0
iam a deo passa	es. Ego autem h	0
m quod in te fa	ctum est a deo 	1
r somnium vidi.	proinde a me ac	0
hominibus irre-	prehensibilis e	1
s esse videris.	Quomodo Anectan	0
tanabus in figu	ra draconis app	1
philippo in con	vivio et oscula	1
s est Olympiam.	Quadam die e-	0
Quadam die e-	pulabatur phili	1
ippus cum prin-	cipibus et prim	1
mis macedoniae.	Praefatio	0
Praefatio	Homelia I	0
Homelia I	Praefatio beati	0
ti Gregorii pa-	pae in Homelias	1
uper Ezechielem	prophetam felic	0
iciter incipit.	Dulcissimo frat	0
 fratri Mariano	episcopo: Grego	0
egorius episco-	pus: servus ser	1
s servorum dei:	homelias quae i	0
e in beato Eze-	chiele propheta	1
a: ut coram po-	pulo loquebar: 	1
: exceptae sunt	multis curis ir	0
bolitione reli-	queram: sed pos	1
petentibus fra-	tribus notarior	1
quirere studui.	easque favente 	0
rens in quantum	ab angustiis tr	0
licuit: emenda-	vi. Tua itaque 	1
 sibi ad legen-	dum mitti popos	1
alde incongruum	credidi ut aqua	0
 hauriret: quem	constat de beat	0
rosii atque au-	gustini torrent	1
da ac perspicua	fluenta assidue	0
d rursum dum co	gito quod saepe	1
ianas delicias:	etiam viliores 	0
apiunt: transmi	si minima legen	1
 dum cibus gros	sior velut pro 	1
r: ad subtilio-	res epulas avid	1
idius redeatur.	Explicit praefa	0
icit praefatio.	Expositio beati	0
ati Gregorii pa	pae in Homelias	1
uper Ezechielem	prophetam felic	0
iciter incipit.	Homelia I	0
Homelia I	Ei omnipotentis	0
potentis aspira	tione de Ezechi	1
 Ezechiele pro-	pheta locuturus	1
locuturus prius	debeo tempora e	0
empora et modos	aperire prophet	0
phetiae: ut dum	accessus eius o	0
ius ostenditur:	virtus melius c	0
s melius cogno-	scatur. Prophet	1
sunt: scilicet:	Praeteritum pra	0
m. Sed sciendum	est quod in duo	0
s prophetia ety	mologiam perdit	1
prophetia dicta	sit deo quod fu	0
quando de prae-	terito vel prae	1
ationem sui no-	minis amittit. 	1
n proditur quod	venturum est: s	0
rat quae trans-	acta sunt: vel 	1
Quae tamen tria	prophetiae temp	0
loquimur: si ex	sacrae scriptur	0
iis ostendamus.	Prophetia de fu	0
. Ecce virgo in	utero accipiet 	0
 Esaiae. 7. ca.	Prophetia de pr	0
t. In principio	creavit deus ca	0
esi. 1. De illo	enim tempore di	0
uo non erat ho-	mo. Prophetia d	1
 est: quando di	cit Paulus apos	1
utem omnes pro-	phetent intrat 	1
idelis vel idio	ta convincitur 	1
dicatur: ab om-	nibus occulta c	1
anifesta fiunt.	Et ita cadens i	0
orabit dominum:	pronuncians quo	0
s in vobis sit.	1. Corinth. 14.	0
ur: occulta cor	dis eius manife	1
rofecto monstra	tur: quia per h	1
hetiae spiritus	non praedicit q	0
t: sed ostendit	quod est. Quo a	0
phetiae dicatur	spiritus: qui n	0
dicat: sed prae	sens narrat? Qu	1
animadvertendum	est quod recte 	0
 non quia prae-	dicit ventura: 	1
it occulta. Rem	quippe quamlibe	0
ulis nostris in	futuro subtrahu	0
: ita ab oculis	nostris in prae	0
t causa. Ventu-	ra etenim res o	1
o tempore: prae	sens autem cogi	1
 in latente cor	de. Est etiam p	1
ns cum res quae	libet non per a	0
sentem locum te	gitur: quae tam	1
m denudatur. Et	ibi sit praesen	0
animus: ubi per	praesentiam non	0
Nam giezi longe	a propheta rece	0
 Naaman syri mu	nera percipieba	1
amen isdem pro-	pheta dicit:	1
pheta dicit:	B Nonne cor meu	0
um in praesenti	erat: quando re	0
versus est homo	de curru suo in	0
occursum tibi?)	Sciendum quoque	0
rophectiae tem-	pora invicem si	1
ad probationem:	ut aliquando ex	0
A 2	perterrita voca	0
 Anectanabum et	dixit. Magister	1
lige de me quid	Philippus cogit	0
Dixit enim ale-	xandro. Fili ve	1
atem tuam dili-	go. et ingenium	1
 animi approbo.	Sed tristis sum	0
a figura tua in	nullo mihi simi	0
ur. Anectanabus	coepit cogitare	0
Cogitatio illi-	us nullatenus e	1
nociva. Solito-	que respiciens 	1
putabat quandam	stellam. se par	0
e desiderium su	um. Audiens hae	1
xander dixit ei	Stellam quam vi	0
 videtur in cae	lo. Cui anectan	1
ixit. Est fili.	Alexander dixit	0
 Potes mihi eam	ostendere. Resp	0
dit Anectanabus	Sequere me hora	0
octis et osten-	dam tibi. Alexa	1
ixit. Fatum tu-	um estne tibi c	1
um aut incertum	Anectanabus res	0
dit. Est satis.	Alexander dixit	0
pto illud cogno	scere. Anectana	1
 respondit Scio	quippe quod a f	0
 debeo recipere	mortem. Cum hae	0
isset descenden	te eo de palati	1
ebatur eum ale-	xander hora ser	1
na extra urbem.	Et cum incedere	0
 supra fossatum	ciuvatis dixit 	0
nabus. Fili ale	xander contempl	1
dera. vide stel	lam herculis qu	1
ter conturbatur	Mercurius vero 	0
o gaudet. Iovem	siquidem video 	0
ruscantem. fata	mea mihi propin	0
uam mortem a fi	lio meo commina	1
tur. Taliter eo	vidente accessi	0
 eum propinqui-	us alexander. e	1
acto impetu eum	corruere fecit 	0
 ad infimam par	tem fossati tal	1
 ei dicens. In-	felix sic te mo	1
cum terrena sci	res cur caelest	1
sisti falsae fu	tura praedestin	1
. Cui Anectana-	bus respondit. 	1
gnitum mihi fu-	it quod tali de	1
icio mori. Non-	ne dixi tibi qu	1
 meus me exstin	guere debebat. 	1
nder dixit. Er-	go filius tuus 	1
um. Anectanabus	respondit. Re v	0
go genui te. Et	haec dicens exp	0
t. Alexander au	tem filiali pie	1
otus elevansque	corpus eius sup	0
meros suos por-	tavit ipsum in 	1
uum. Cumque vi-	deret illum Oly	1
ixit alexandro.	Fili alexander 	0
st hoc. Cui il-	le respondit. C	1
anectanabi est.	Olympia dixit. 	0
ectanabus pater	tuus fuit. Resp	0
 ille. Quemadmo	dum stultitia f	0
 est. Et iussit	illud sepeliri.	0
illud sepeliri.	Qualiter quidam	0
princeps de Ca-	padocia adduxit	1
m bucifallum ad	Philippum regem	0
egem macedonum.	In ipsis deni-	0
In ipsis deni-	que temporibus 	1
bus princeps Ca	padociae adduxi	1
adduxit unum e-	quum indomitum 	1
gnum corpore et	pulchrum nimis.	0
que ex omni par	te cathenis fer	1
 Comedebat enim	ille equus buci	0
lus homines pro	pter aspectus h	1
tem. sive a si-	no quod thaurin	1
t quod maius ha	bebat ustum. se	1
te eius quaedam	mine corniculor	0
rocedebant. Cum	igitur vidisset	0
ppus rex ipsius	equi pulchritud	0
dixit ministris	suis. Conficite	0
llos ferreos ut	latrones qui mo	0
nt ex lege tru-	cidentur ab eo.	1
cidentur ab eo.	Qualiter revela	0
latum fuit Phi-	lippo quod ille	1
m regnare debe-	bat qui dictum 	1
quum bucifallum	equitabit. et d	0
ndro sedente in	curru et de ver	0
abitis cum rege	arridorum.	0
arridorum.	Quomodo nuntii 	0
ntii Darii impe	ratoris venerun	1
ollendum tribu-	ta consueta dar	1
hilippum patrem	alexandri. et d	0
sione ipsis fa-	cta per alexand	1
per alexandrum.	Post haec vene	0
Post haec vene	runt reguli mul	1
i multi a dario	destinati ad ph	0
ad philippum re	gem census et t	1
quaerentes. Qui	bus alexander d	1
t. Dicite Dario	imperatori nost	0
stquam enim Phi	lippi filius ad	1
allina quae ova	aurea generabat	0
umpta est steri	litate. et Dari	1
tis et censibus	est privatus. A	0
tes haec nuntii	darii mirati su	0
de ex prudentia	et sermonibus e	0
reversi sunt ad	Darium regem pe	0
regem persarum.	Qualiter alexan	0
r ivit ad expu-	gnandum armenia	1
su Philippi. et	rediens cum vic	0
terfecit pausa-	niam qui in Phi	1
pum patrem eius	irruerat. et ip	0
sum interfecit.	Interea nuntiat	0
terea nuntiatum	est philippo re	0
sset contra eum	arma armenia qu	0
t subdita illi.	Et praeparato e	0
rexit illuc ale	xandrum ut pugn	1
illis. illamque	iugo suo subice	0
at autem quidam	homo tunc in ma	0
acedonia nomine	et velox subdit	0
ilippo. Hic cum	multis temporib	0
oncupisceret O-	lympiam coniura	1
em fecit contra	Philippum. Et c	0
ongregato popu-	lo hostiliter a	1
ntra regem. Au-	diens haec Phil	1
 obviavit ei in	campo cum pauci	0
Vidensque multi	tudinem quam Pa	1
ausania duxerat	tergaversus auf	0
 Quem insecutus	pausania vibrat	0
a perfodit eum.	Qui quamvis for	0
emivivus. Maxi-	ma siquidem tur	1
a est inter ma-	cedones dum spe	1
t eum esse mor-	tuum. Et pausan	1
 superbia eleva	tus intravit au	1
alatium. et ex-	inde Olympiam t	1
s ut secum duce	ret et eam habe	1
ccidit autem ut	alexander victi	0
eniis triumphum	reportaret vict	0
nvenit in regno	turbationem max	0
am de Philippo.	Olympia autem e	0
 incognitum lo-	cum palatii ut 	1
gna et vexilla.	victoriae Alexa	0
epit vociferare	ad eum dicens. 	0
nder ubi est fa	tum quod a diis	1
ti ut victor et	non victus exis	0
s. Audiens pau-	sania adventum 	1
andri exit con-	tra eum. Quem u	1
it alexander fa	cto impetu et e	1
ato gladio tru-	cidavit eum.	1
cidavit eum.	Qualiter venit 	0
t ad alexandrum	quod Philippus 	0
ius nondum erat	exstinctus. et 	0
cum decet amico	quando in medio	0
vocalem ante se	positam subsequ	0
a: ut maius pe-	ius eius in quo	1
 i. litteram et	maiius peiius e	0
ari posset quam	si cum superior	0
proferentur: ut	peiius eiius ma	0
bus accipiebant	nam quamvis. i.	0
inata iungi non	posset. Ergo no	0
ebuit. Unde pom	peii quoque gen	1
m duo superiora	loco consonanti	0
am tribus. iii.	iunctis qualis 	0
emum. i. pro vo	cali est accipi	1
grammaticae pla	citum fuisse: a	1
syllabis compro	batur. Pro simp	1
umine reiice ca	pellas. Nunquam	1
nsonantis aspi-	ratio inveniri:	1
ulcus trisylla-	bum est: nulla 	1
ecipit. V. vero	latinos quam ap	0
nomen hoc datur	quod apud aeole	0
 voce profectum	teste Varrone: 	0
nt: pro quo Cae	sar hanc figura	1
li rectum visum	est: tamen cons	0
 hoc verum esse	quod pro aeolic	0
li solebant ac-	cipere digamma.	1
ste Astyage qui	f. digamma posi	0
xterrita mater.	Est tamen quand	0
e coniugationis	in quibus. i. a	0
acta corripitur	ut cupivi cupii	0
am. Inveniuntur	¶ Ioannes Adelp	0
sicus: Excellen	ti viro. D. Iac	1
chenck Iurecon-	sulto optimo: a	1
c Vuormaciensis	Ecclesiae Offic	0
iali benemerito	domino et praec	0
praeceptori sem	peramando. S. P	1
mando. S. P. D.	Rogatus a pleri	0
litteraturae a-	matoribus: Theo	1
resemundo (piae	memoriae). Offi	0
oguntino homine	dum viveret lit	0
 et inter germa	nos doctissimo:	1
 Iacobo Oeszler	Iureconsulto op	0
nc rem plurimum	opitulabatur: e	0
ris scripturae:	et paene oblite	0
atius exiret in	publicum Alexan	0
nsulani Praesu-	lis (ut vult do	1
nsis de Tritten	heym: in suo qu	1
iasticis edidit	libello) quam e	0
 bonarum disci-	plinarum cultor	1
s Iudex pius et	iustus: Renato 	0
rum pridem dede	ras imprimendam	1
ra in hac re di	ligentia ut pii	1
ibuslibet satis	fieret. Itaque 	0
 curavimus: quo	gloriam capiat 	0
rpetuae: ne sic	pereat labor bo	0
itus: sed somno	lentos excitet 	1
is enim prodest	quod multis scr	0
ibus ut discant	principibus ut 	0
der ille magnus	Macedoniae rex:	0
splendor: et in	hoc uno laudand	0
s ad usque side	ra: quod a manu	1
summamque sapi-	entiam in promp	1
s omnis. Nostri	vero principes 	0
gubernator Maxi	milianus Caesar	1
o rem collapsam	restituere cona	0
tur et utuntur.	Ille quibus fru	0
 nos beatos fa-	ciunt. Istis qu	1
dum est tenden-	tes ad beatitud	1
uvamur et quasi	adminiculamur u	0
as res quae nos	beatos faciunt 	0
isque inhaerere	possimus. Res v	0
ruuntur et utun	tur. nos possum	1
er utrasque con	stituti. et ang	1
 frui autem est	amore alicui re	0
opter se ipsam.	uti vero est id	0
 venerit. refer	re ad obtinendu	1
ud quo fruendum	est. alias abut	0
. Nam usus illi	citus. abusus v	1
nominari debet.	Res ergo quibus	0
um est sunt pa-	ter et filius e	1
us. Eadem tamen	trinitas quaeda	0
st. communisque	omnibus fruenti	0
 tamen res dici	debet et non re	0
causa. si tamen	et causa. Non e	0
potest inveniri	nomen quod tant	0
conveniat/ nisi	quod melius dic	0
 haec unus deus	Res autem quibu	0
est. mundus est	et in eo creata	0
augi. in eodem.	Utendum est hoc	0
on fruendum. ut	invisibilia dei	0
facta sunt. in-	tellecta conspi	1
t ut de tempora	libus aeterna c	1
 Item in eodem.	In omnibus rebu	0
tum sunt quibus	fruendum est. q	0
et incommutabi-	les sunt. Ceter	1
 utendum est ut	ad illarum perf	0
rveniatur. Idem	augi. in li. x.	0
mur cognitis in	quibus ipsis pr	0
untas delectata	conquiescit. Ut	0
s quae ad aliud	referimus quo f	0
o fruendum est.	¶ Item quid int	0
rui et uti ali-	ter quam supra.	1
ter quam supra.	Notandum vero q	0
d idem Augi. in	li. x. de trini	0
quam supra acci	piens uti et fr	1
 dicit. uti est	assumere aliqui	0
ultatem volunta	tis. frui autem	1
 gaudio non ad-	huc spei. sed i	1
eoque omnis qui	fruitur utitur.	0
m aliquid in fa	cultatem volunt	0
 delectationis.	Non autem omnis	0
 fruitur. si id	quod in faculta	0
is assumit. non	propter ipsum. 	0
appetit. Et at-	tende quia vide	1
 illos frui tan	tum qui in re g	1
n iam in spe et	ita in hac vita	0
r frui sed tan-	tum uti. ubi ga	1
 spe. cum supra	dictum sit. fru	0
nhaerere alicui	rei propter se.	0
m hic multi ad-	haerent deo.	1
haerent deo.	¶ Determinatio 	0
dent contraria.	Haec ergo quae 	0
contradicere vi	dentur sic dete	1
minamus. dicen-	tes nos et hic 	1
in futuro frui.	sed ibi proprie	0
 plene. ubi per	speciem videbim	0
emur. Hic autem	dum in spe ambu	0
 fruimur quidem	sed non adeo pl	0
 li. x. de tri.	Fruimur cogniti	0
s voluntas est.	Idem in li. de 	0
stiana ait. An-	geli illo fruen	1
ti sunt. quo et	nos frui deside	0
 quantum in hac	vita iam fruimu	0
speculum vel in	aenigmate tanto	0
peregrinationem	et tolerabilius	0
us et ardentius	finire cupimus.	0
m dici quod qui	fruitur etiam i	0
on tantum habet	gaudium spei. s	0
 iam delectatur	in eo quod dili	0
iam rem aliqua-	tenus tenet. Co	1
go quia debemus	deo frui et non	0
im ut ait augi.	frueris quo eff	0
atus. et in quo	spem ponis ut a	0
rvenias. De hoc	idem ait in li.	0
christiana. Di-	cimus nos ea re	1
ligimus propter	se. et ea re fr	0
st vel esse tan	tum qua efficim	1
teris vero uten	dum. frequenter	1
ur frui. cum de	lectatione uti.	1
est quod diligi	tur. etiam dele	1
m gerit. si ta-	men per eam tra	1
d illud ubi per	manendum est. e	0
s. uteris ea et	abusive non pro	0
ui. si vero in-	haeseris atque 	1
finem in ea po-	nens laetitiae 	1
proprie frui di	cendus es. quod	1
um nisi in illa	¶ Actoris epist	0
ctoris epistola	¶ Incipit felic	0
iter doctissimi	ac famosissimi 	0
erii liber: qui	Manipulus curat	0
o pernecessaria	officia eorum q	0
undum septem sa	cramentorum ord	1
 pertractantur.	Actoris epistol	0
ctoris epistola	Reverendo in ch	1
endo in christo	patri ac domino	0
providentia san	ctae valentinae	1
votorum minimus	Guido de monte 	0
evota et humili	recommendatione	0
sequiis mancipa	tum. Fons sapie	0
 ordinans et di	sponens militan	1
r ecclesiae tri	umphantis. Quod	1
ysi quando fuit	sibi praeceptum	0
mplar quod fue-	rat sibi in mon	1
s mundi deserto	constructum est	0
ordinata. Cuius	quidem militant	0
heta rememorans	per montes prae	0
t. qui ad modum	spirituum super	0
t praelatos il-	luminant: perfi	1
ibus illuminati	scientiis perfe	0
eriores saecula	res scilicet et	1
 quod facere ne	queunt nisi fue	1
go attendens et	vigili meditati	0
structione neo-	phytorum curato	1
ili. non curans	de verborum orn	0
Quod quidem opu	sculum ad vos q	1
um. qui lucetis	velut lucerna l	0
 qui radio divi	nae sapientiae:	1
lo correctionis	caritativae sub	0
ficitis et pur¬	gatis: duxi hum	1
orrectionis ve-	strae politum p	1
illa non audet.	dominus univers	0
ernus deo patri	Qui caelos verb	0
ivit hominemque	manibus proprii	0
hunc immortali-	tate donavit. r	1
e in terra sunt	constituit et q	0
mnibus pulchri-	orem paradisum 	1
it. Qui invidia	diaboli deceptu	0
e heu prohdolor	illectus miserr	0
iis corruit bo-	nis. Nam qui pr	1
ctus factus est	miserrimus lacr	0
miserrima omni-	modo plangendus	1
s formaverat et	creaverat benig	0
spiciens oculis	opus manuum sua	0
et non amittens	quod erat ab in	0
pter nos absque	peccato quod su	0
rucem sponte ac	mortem sustinen	0
supradictum qui	primum parentum	0
it et de illius	amara servitate	0
pristinam beni-	gnissime restit	1
Et unde propter	in obedientiam 	0
illuc denuo sua	nos reduxit mis	0
pristino honore	efficiens digno	0
 qui talia prop	ter nos passus 	1
onis nos iterum	dignos effecit 	0
n illius crucem	offendis. Totus	0
 corporis dedi-	tus et extermin	1
passionibus. De	os appellas ign	1
is idola et non	tantum te ipsum	0
hereditate alie	num efficis sed	1
eptis obaudiunt	¶ Abbas potest 	0
mptas a monacho	vel pecuniam si	0
monaci sui exi-	stentis in alio	1
rint ad abbatem	secundi monaste	0
s. §. servum in	ult. col. ad fi	0
e. et ult. col.	ff. si cer. pe.	0
r eum signatis.	¶ Abbas potest 	0
onaſterii etiam	praesente et ta	0
o in. l. filius	fam. ff. de pro	0
ff. de procura.	Abbas recipiens	0
erii qui revera	non est monachu	0
um Bald. in. l.	non idcirco. in	0
. et fac. igno.	¶ Abbas recipie	0
m ab emphyteota	cum solvens non	0
 asserere illum	esse emphyteota	0
de iur. et fac.	igno. quid aute	0
ta numquid sibi	praeiudicet et 	0
quod non de quo	plene per. d. I	0
 de iure emphy.	¶ Abbas vendica	0
a. iij. in. fi.	¶ Abbas datum f	0
ri defecta igno	rantia doctoris	1
 cer. pet. quod	dictum an ita i	0
dernos et maxi-	me. d. alex. in	1
e. et ult. col.	¶ Abbas potest 	0
icto sibi facto	etiam cum condi	0
si relictum sit	pro alimentis. 	0
ddo bal. in. l.	i. in. vj. q. C	0
 quae pe. nomi.	30 ¶ Abbas non 	0
 suo monasterio	in praeiudicium	0
eccles. aedifi.	et Inno. in. c.	0
et. c. noverint	¶ Abbas praescr	0
rali licet ipse	remaneat subdit	0
aescrip. et ibi	doc. et Sicu. i	0
t Inno. ibi. in	ii. column. in 	0
iam. eo. ti. in	iiii. col. in p	0
simpliceter di-	cit quod eccles	1
in. c. cum olim	in. ii. col. in	0
liceat. in. vi.	col. ver. venio	0
tertiam eo. ti.	¶ Abbas potest 	0
achos non alios	clericos. Item 	0
 quem episcopum	voluerit. c. cu	0
aescribi potest	de praescrip. n	0
 in. c. veniens	de praescrip. e	0
nto. de consue.	¶ Abbas potest 	0
 sicut sacerdos	et benedictus. 	0
ix. di. quoniam	de eta. et qual	0
tatuimus. et in	spe. de eta. et	0
tatuimus de sta	tu. monach. et 	1
x. di. quoniam.	¶ Abbas non pot	0
lebrare divinum	officium nisi e	0
 quod est verum	secundum Host. 	0
ebrare officium	monachale. secu	0
cclesiae ut ibi	etiam per Sicu.	0
. xvi. q. i. c.	ii. et cle. ii.	0
de cele. missa.	¶ Abbas in caus	0
or capituli. In	no. in. c. sopi	0
ide. in spe. de	iur. calum. §. 	0
quod collegium.	¶ Abbas praesum	0
rem de consensu	capituli nisi c	0
 his quae fi. a	prae. sine cons	0
ar. ver. xiiii.	¶ Abbas potest 	0
s habeat certos	redditus. glo. 	0
n verbo de omni	bald. in mar. v	0
 in ver. abbas.	¶ Abbatis elect	0
t electus licet	nondum sit bene	0
nondum confirma	to. Oldr. in co	1
r an beneficium	et .i. q. ij. s	0
. de sta. regu.	¶ Abbas potest 	0
ia episcopi non	obstante iurame	0
incipiente. fa¬	ctum tale est q	1
t quidam abbas.	40 ¶ Abbas non 	0
dis. iiii. mona	chi. et. c. non	1
on licet el. i.	¶ Abbas etiam p	0
cum inter mona-	chos. l. di. ac	1
. di. accedens.	¶ Abbas an pote	0
 vi. presbyter.	Io. an. in. c. 	0
 privi. in. vi.	¶ Abbas imperit	0
scretus et peri	tus in regula. 	1
 eta. et quali.	¶ Abbas an revo	0
to pro patroci-	nio ferendo in 	1
defendere. bar.	et doc. et alex	0
. si cert. pet.	¶ Abbates non p	0
 vestes calices	cruces et alia 	0
i ex privilegio	vel consuetudin	0
u. mona. ix. q.	¶ Abbas aliquan	0
lariter pertine	at ad episcopum	1
r. su. et bald.	ubi supra. v. x	0
nsatio abbatis.	¶ Abbas potest 	0
itutum a conven	tu. Inno. in. c	1
batem de teste.	li. vi. et bal.	0
r. ff. quod cu-	ius. uni. no. e	1
verum ante lit.	contest. non po	0
ndum Inno. ibi.	¶ Abbas censetu	0
 non ut persona	singularis. Inn	0
fi. in glo. sua	in verbo ab eis	0
er. abbas. ver.	xi. ubi hoc int	0
n contractibus.	¶ Abbas tenetur	0
ssitatibus suis	sicut dominus s	0
is quae pe. no.	¶ Abbas potest 	0
ationem post 50	biennium. c. qu	0
j. q. C. de his	quae pe. no.	0
quae pe. no.	¶ Abbatis conse	0
quando monachus	accusatus vult 	0
. col. in. ver.	quaero numquid 	0
de bo. quae li.	¶ Abbas licet o	0
ionis non tamen	per hoc videtur	0
n. c. inter mo-	nasterium. de r	1
um. de re iudi.	¶ Abbas potest 	0
gatum factum mo	nacho eo invito	1
ex repudiatione	in fi. C. de fi	0
 ix. immo etiam	haereditatem re	0
o. po. Sed bal.	in. l. i. x. q.	0
mitti. dic quod	abbas potest ad	0
n recusante non	potest repudiar	0
 quaero quid si	est institutus.	0
 se. consi. ix.	Dy. et doc. in.	0
s puto. §. fun-	dum. ff. de re.	1
a. cre. et Bal.	in. l. fi. in p	0
e bo. quae. li.	et per bar. in.	0
lud est. ff. de	acqui. haere. e	0
t ver. monachus	succedit per to	0
edit per totum.	¶ Abbas potest 	0
 ad celebrandum	missam. Solutio	0
m. Utrum nequis	possit licite q	0
 vel superioris	dummodo habeant	0
ium. Quid si in	terra vel regio	0
r destructionem	et vastationem 	0
in navigatione.	ubi non potest 	0
ili: occurrente	casu. Utrum neq	0
. ¶ Solutio. In	talibus casibus	0
ssae requisita.	potest enim cel	0
. Utrum in mari	vel in fluminib	0
brare. Solutio.	Nullo modo debe	0
. Utrum in omni	loco consecrato	0
terdictus. sive	a iure ut si po	0
nterdicti latam	contra locum il	0
rregularitatem.	¶ Articulus. se	0
urrere possunt.	Dubium. primum.	0
uo alio quam su	per altari. Sol	1
tatili sive via	tico. quod pote	1
undum. Quale de	beat esse altar	1
atum. non enor-	miter fractum. 	1
tum et ornatum.	¶ Solutio Duabu	0
llo colore tin-	ctis. sed total	1
liceat sacerdo-	ti super qualib	1
opus aliquis su	per aliquo alta	1
 illo altari ce	lebrare. nisi d	1
e portatile. ut	sit aptum celeb	0
 recipere pedem	accipit conclus	0
tia. quia ratio	est virtus coll	0
 est comparatio	simplicis ad co	0
lineam in essen	do: talis est c	1
lici ad intelle	ctum hominis in	1
cando. Cum ergo	iudicium fiat a	0
ngelus secundum	statum suae con	0
non in tempore:	et de re tota s	0
 de ipsa: videt	eam totam ſimul	0
 Si ergo peccat	in iudicando pa	0
ertissima mali-	tia. Nullo ergo	1
o eius peccatum	est irremediabi	0
de homine. Unde	cum totam rem n	0
cipi in suo iu-	dicio. Et ita c	1
qua modo possit	excusari: non e	0
de. gen. 6. Non	permanebit spir	0
aro est. ¶ Item	alium hominem: 	0
 non debuit re-	parari. Et cum 	1
 generis: patet	quod non fuit p	0
 in angelo: sic	fuit in homine.	0
em peccati vari	atur considerat	1
o genus peccati	Attendendo circ	0
. Attendendo oc	casionem peccat	1
us: tam angelus	quam homo pecca	0
nter. Homo enim	peccavit appete	0
 Gen. 3. Eritis	sicut dii scien	0
d angelus pecca	vit: appetendo 	1
a. 14. Ascendam	in caelum et ce	0
omnipotentia et	omnisapientia. 	0
 voluit communi	care alicui cre	1
pium. quia ergo	angelus appetit	0
deo in potentia	propter hoc app	0
lo modo erat or	dinatus. Et pro	1
nem aliquam. Et	propter hoc pec	0
bile. Scientiam	autem omnem vul	0
 illam enim est	homo ordinatus 	0
am omnium. unde	et christus sec	0
 appetere illud	ad quod nulla c	0
ata. homo autem	erat ordinatus 	0
appetebat. ideo	peccatum homini	0
peccatum angeli	non. quia illud	0
prium creatoris	Nam in Adam fui	0
. nam peccatum:	quod erat morta	0
le. sicut dicit	Aug. unde non t	0
e: quantum pec-	cavit. Angelus 	1
rantiam in pec-	cando. Intellec	1
bumbratus erat.	unde defecit a 	0
illam obumbran-	tiam non potera	1
e de facili. Et	propter hoc non	0
: sicut angelus	¶ Item habuit p	0
 et petendi ve-	niam de peccato	1
sse veniale. An	gelus autem non	1
iritum sanctum.	homo non. Et ta	0
emediabile est.	¶ Item attenden	0
atet. quod homo	non peccavit se	0
scilicet uxore.	Uxor similter s	0
suasa a serpen-	te. Iuſtum ergo	1
: per alium re-	levetur. Sed an	1
vit. et propter	hoc per alterum	0
c etiam se ipso	potuit: sicut d	0
m ad congruita-	tem divinae ius	1
homine uno erat	tota ſpecies hu	0
ltiplicata: sed	postea multipli	0
d in angelo pec	cante non erat 	1
. immo iam tota	multiplicata er	0
vinae iustitiae	congruum fuit. 	0
iret vel iudica	ret hominem. qu	1
ec species huma	na multiplicare	1
merus electorum	Et tunc iudicar	0
essent puniendi	Sed statim debu	0
m. unde dilatio	ista non habuit	0
homine. Et pro-	pter hoc angelu	1
atus. homo vero	puniendus iudic	0
nem speciei hu-	manae. Et hoc e	1
cio particulari	vel in fine pos	0
orum iudicio ge	nerali. Et tunc	1
m. sicut nec an	geli est mors. 	1
Quod est homini	mors hoc est an	0
 quantum ad exi	gentiam divinae	1
et sunt in uni-	verso. 8. ratio	1
omine erat tota	natura humana. 	0
tura perdita et	corrupta. Sed n	0
rdiae et summae	bonitati. ut na	0
 ex toto perire	sineret. Et ide	0
ominem. sed cor	rupto angelo et	1
o tota angelica	natura perdita 	0
a erat in illo.	et quia corrupt	0
corruptio unius	personae. ideo 	0
ati sicut homo.	Ad primam ratio	0
primam rationem	per quam ostend	0
. et contrarie.	¶ Irremediabile	0
quod nullo modo	potest remitti.	0
vative est quod	non habet aliqu	0
t remitti. ¶ Ir	remediabile con	1
ispositionem ad	remittendum. si	0
potest remitti.	¶ Primo modo di	0
peccatum angeli	et peccatum dam	0
iat. multa enim	mala docuit oti	0
Illas vero scri	pturas libentiu	1
ue quae tuam de	votionem magis 	1
 quam quae alli	ciunt intellect	1
quae dico dabit	tibi dominus in	0
in sensu cogita	veris circumspe	1
Et cum oraveris	non impleas aur	0
 singultibus et	suspiriis. sed 	0
eum tuum in cu-	bili cordis. pr	1
d compunctionem	habendam si ita	0
ueris vel puras	manus elevando.	0
psius vocem au-	dire potueris n	1
 ad sublevandam	intentionem in 	0
 ut ibi sit cor	tuum ubi christ	0
tra dei sedens.	Ab oratione rev	0
ectionem et ite	rum si lectio i	1
m submoverit ad	orationem provo	0
nsortia iuvenum	maxime qui inba	0
unt quantum con	venienter potes	1
ta Sicut ad cru	cem sic ad cibu	1
as. numquam ali	cui oculos in f	1
efigas. numquam	voluptate: sed 	0
itate pascaris.	Et fames non sa	0
vocet appetitum	praefatio de ap	0
em Nicolao Bar-	bara et Lucia C	1
tio cottidiana.	¶ Quando autem 	0
erit patrocini-	um alicuius ecc	1
ut praemittitur	de sanctis ipsi	0
adventu poterit	dominica die ce	0
Et pro tunc ibi	dem officium do	1
m diem feriatam	transponitur: e	0
ndo festum con-	ceptionis beata	1
c propter offi-	cium dominicale	1
estum conceptio	nis beatae Mari	1
em transponitur	ibidem in choro	0
t erit officium	missae de festo	0
llecta. Secreta	et complenda de	0
nitur nomen Na-	tivitatis in pr	1
eptionis Praefa	tio Et te in co	1
riae et cetera.	Nota quod ferii	0
tum sanctae Lu-	ciae habetur Ie	1
ttuor temporum.	De vigilia nati	0
itatis christi.	¶ In vigilia na	0
vigilia dicitur	sicut in libro 	0
elsis. Alleluia	Sequentia Credo	0
fragium vero de	beata virgine e	0
onclusio missae	erit benedicamu	0
d quando praedi	cta vigilia in 	1
Veni domine. et	Credo adiungunt	0
bus omittuntur.	De festo nativi	0
itatis christi.	¶ In nocte nati	0
o in matutinis:	videlicet Verbu	0
ssa prima de fe	sto nativitatis	1
equentia Grates	nunc omnes Cred	0
nati Communican	tes et noctem s	1
sollemniter di-	cuntur quamvis 	1
no. Et post con	clusionem datur	1
legetur evange-	lium Liber gene	1
cantatur Te de-	um laudamus. et	1
 ¶ Nota quod vo	lucernam. ut da	1
inativa. Deinde	appropinquat. e	0
 eius. deinceps	elevatur a dile	0
cipitur ad oscu	lum pacis. Dein	1
r manere cum eo	liquescit in ei	0
 quaerit. vocat	suspirat. inven	0
det. alta fasti	dit. soli illi 	1
 et post longum	tempus in eo qu	0
 eius. ¶ Ex iis	et aliis possun	0
et secundum hoc	erunt xv capitu	0
mentis in deum.	Et hoc de praeo	0
equitur tabula.	Incohativa	0
Incohativa	Purgativa	0
Purgativa	Illuminativa	0
Illuminativa	Instructiva	0
Instructiva	Imitativa	0
Imitativa	Via	0
Via	Exemplativa	0
Exemplativa	Admirativa	0
Admirativa	Comparativa	0
Comparativa	Compassiva	0
Compassiva	Via	0
Via	Affectiva.	0
Affectiva.	Superlativa.	0
Superlativa.	Orativa.	0
Orativa.	Unitiva.	0
Unitiva.	Exsultativa	0
Exsultativa	¶ De via incoha	0
more. ideo haec	Tractatus de ap	0
rum post exitum	earum a corpori	0
taculis. editus	in erfordia ab 	0
Iacobo de Clusa	ordinis cartusi	0
sore doctissimo	Rogamus vos ne 	0
spiritum. Verba	sunt apostolica	0
dem consolantia	ne terrore conc	0
ones. arbitrans	quasi tunc inst	0
 futura. ut pa-	tet ex sequenti	1
uli. ubi aposto	lus praedicit e	1
is. quem nos an	tichristum dici	1
gnis mendacibus	Quae verba non 	0
d propositum no	strum Fateor en	1
te a multis pul	satam quid opin	1
undam spirituum	in quibusdam mo	0
s. sive domibus	qui quandoque n	0
ibili se osten-	tat. lapillos o	1
ntes. mensas et	scamna subverte	0
bativa exercent	ut etiam habita	0
tationes sollem	nes deserere no	1
o certam me fa-	teor habere not	1
 cum eisdem. et	licet orationes	0
eremonialia ser	vata non tamen 	1
 Quid igitur de	hoc possit tard	0
 materia videre	prout deus dona	0
ibus non negabo	manifestare. no	0
s et verius sen	tientibus. prot	1
lis theologicis	fieri consueta.	0
semper salva et	praemissa. Nec 	0
r aliquid de ta	libus speculari	1
at dinosci. pri	mo propter turb	1
ium summovendam	PARTHENICES PRI	0
THENICES PRIMAE	Et nostrae sine	0
biere iuventae:	Longa infelicis	0
 consortia fine	Claudimus infau	0
us exulat annis	Conspectus homi	0
s orba magistro	Fluctuat/ amiss	0
 aequore clavo.	Currimus in fat	0
ecedimus annis:	Mortuaque aetat	0
maxima nostrae:	Pallida praeter	0
s occupat aevi.	Quod superest e	0
am plena meorum	Terra cadaverib	0
osque sepulchra	Vix capiunt: so	0
ervamur in omne	Dedecus: et cer	0
t felicior aevi	Condicio. primo	0
ulsisse Parenti	Creditur: et fr	0
luisse senectae	Cum vetuit prim	0
erpere fructus:	Et fruges gusta	0
oduceret annos.	Nam quid longa 	0
i longa dolorum	Colluvies: long	0
 carceris aetas	Anna diu vanos.	0
piens a sterili	tate Annae: qua	1
batur. Orat er-	go Deum omnium 	1
ut semen fecun-	det in senili a	1
t sterilitatem.	Dicit autem omn	0
arios cursus si	ve solo nutu di	1
s ostendens. Mo	vet tum commise	1
ta: a morte con	sanguineorum: a	1
raestitum aliis	nam ita genitus	0
Annaeque filius	Samuel qui Saul	0
t. Genesi. iii.	Longior: est cu	0
nthus: in ipsum	Ex utero ingred	0
 mortis abimus.	Iam capulo inst	0
 lumina claudat	Fo.	0
Fo.	medici caelesti	0
tandem sanitati	redditus ut pen	0
r a miseris non	inferiori mirac	0
nsolitae gravi-	tatis ut qui ol	1
ivis autem ser-	vorum manibus e	1
is nixus lentis	terram passibus	0
e te dominum vi	dit atque exule	1
or viderere Nul	li fere nostrum	1
lli par fuit in	iuria aut cum p	1
tuam niterentur	idem ipsi de nu	0
 quasi communi-	cato consilio c	1
 insidiis pete-	ret auro prius 	1
s tot per annos	propitiae ac fa	0
ior iactura est	amicis atque cl	0
idem sed diver-	sis tormentorum	1
 Parsque clemen	tior fuit illud	1
ines domos opi-	da invaderet ut	0
operibus ad in-	opiam redactum 	1
arentur. Amico-	rum ut dixi par	1
ue quod assolet	cum prosperitat	0
ses atque amico	rum prius ac fi	1
medio rem aestu	aegritudo paene	0
 ut quem vivere	amplius non pos	0
ulgaret. Et hic	moribus haec pa	0
 patria procul-	dubio in alieni	1
nte ac semi ob-	sessum oppresse	1
i cum amicos Si	quos aut virtus	0
t seu colloquii	seu litterarum 	0
r carcerem defu	it ac mortem qu	1
sima coniunx et	pars tuorum vis	0
pti essent nul-	lo prorsus tibi	1
s quidem dum et	tu secum assidu	0
c teneram et in	sontem animam i	1
 impletum in te	uno vidimus quo	0
 mario magnoque	pompeio legimus	0
aud umquam lae-	ta tristibus mi	1
t gloriosissime	quoniam iniquam	0
spicionem quasi	velis eius appr	0
um et temptando	te dixit ea qua	0
go et tonde co-	mam tuam et eve	1
a splendida ci-	licium indue su	1
accede ad regem	Illo vero inter	0
bi vult habitus	iste. Respondeb	0
terna die locu-	tus es o rex ec	1
qui te per viam	qua desideras a	0
i deliciae sunt	amabiles atque 	0
 contingat mihi	post te iis per	0
im via qua itu-	rus es et si di	1
era tamen tecum	existenti facil	0
amabilis et pla	na. Sicut enim 	1
praesentium ho-	norum sic et tr	1
ut et futurorum	tecum sim parti	0
 Nobilis igitur	ille vir infirm	0
ecit iuxta quod	ei locutus est.	0
t audiens super	hoc vehementer 	0
ga se veram vi-	ri intellexit a	1
ae contra illum	dicta sumerat a	0
ampliori honore	et maiori fiduc	0
 sublimavit eum	adversus monach	0
ra denuo nimium	replebatur illo	0
cens dogmata ut	removeant homin	0
e delectationi-	bus et quasi in	1
m spei abdicant	taciturnitati t	0
huius historiae	qui tantae phil	0
utentes posteri	beatissimo et f	0
dem. sermo pro-	cedens. ut potu	1
 ad narrationem	rerum. cooperat	0
abebit praesens	scriptura princ	0
ura principium.	Quartum.	0
Quartum.	CRISPO ET CONST	0
TINO CAESARIBUS	atque consulibu	0
trius praeside-	bat. Alexandrin	1
morum macharius	Antiochiae vero	0
nondum quisquam	fuerat ordinatu	0
 Non longo post	tempore hi qui 	0
antes eustachi-	um dignum appro	1
e. Et cum esset	episcopus vicin	0
stulerunt. Tunc	ergo episcopi o	0
ti circa libyam	commorantes non	0
 convenire. Cum	licinius favore	0
. Sed neque per	occidentem hell	0
n religione du-	rabant. propter	1
in his partibus	romanorum. Huic	0
ima postea pro-	venisse percepi	1
venerari: prae-	cipue tamen sig	1
ensum. Socrates	Et quoniam ad h	0
iquid referamus	Cum diocletianu	0
privatam elegis	sent vitam et m	0
eraverat tenens	italiam duos ca	0
e. et in italia	severum. Tunc c	0
ortuo ordinatur	imperator. prim	0
imae olympiadis	vicesima septim	0
ianis militibus	maxentius. maxi	0
ator. Hinc eius	pater imperandi	0
re: quod facere	nequivit. Post 	0
. Porro severus	romae contra ma	0
e peremptus est	Maximinus autem	0
ugustum moritur	Proinde maxenti	0
eria impudenter	gemmis ornata u	0
s domini nostri	iesu christi et	0
ra ut congnosca	mus quia caro n	1
d est in terram	Portat etiam an	0
eum plenum auro	ut omnes intell	0
um Omnibus divi	tiis quae sunt 	1
lit magnificen-	tia nostra Inte	1
tiri potest. et	si quis ibi sci	0
i mortuus inter	nos reputatur n	0
nos nec honorem	apud nos ulteri	0
ritatem et dili	gimus nos adinv	1
 nos regnat Sin	gulis annis vis	1
ae cum exercitu	magno quod est 	0
s propter tyros	et alios serpen	0
d nos capiuntur	pisces quorum s	0
 habemus multas	gentes fortissi	0
us et bragmanis	De palatio.	0
De palatio.	Palatium vero q	0
s nostra est ad	instar palatii 0	
ificavit gondo-	foro regi In di	1
et reliqua stru	ctura per omnia	1
 epistilia sunt	de lignis setim	0
ii est de ebeno	ne aliquo casu 	0
emitatibus vero	supra culmem pa	0
 et in uno quo-	que duo carbunc	1
die. carbunculi	luceant in noct	0
 de sardonio im	mixtae cum corn	1
veneno latenter	possit intrare.	0
enestrae de cry	stallo Mensae u	1
e ex auro aliae	ex amethysto. C	0
mensas ex ebore	a iiii	0
a iiii	Primus Actus	0
Primus Actus	Sivi animum ut  0	
oret suum: nunc	Hic dies aliam 	0
mores postulat.	Dehinc postulo:	0
: ut redeat iam	In viam. DA. mi	0
 quaeris dicam.	Omnes qui amant	0
 uxorem ferunt.	Da. Ita aiunt. 	0
am rem improbum	Ipsum animum ae	0
umque applicat.	DA. Non hercle 	0
. SI. non: hem.	DA. Davus sum n	0
mpe ergo aperte	Vis quae restan	0
 SI. si sensero	Hodie quicquam 	0
onari quo fiant	Minus: aut vell	0
endere quam sis	Callidus: verbe	0
pristinum dedam	Usque ad necem:	0
e inde exemerim	Ego pro te mola	0
n nondum? etiam	Ne haec quidem.	0
 ipsam rem modo	Locutus nihil c	0
itione usus es.	SI. Ubi vis fac	0
 re me deludier	DA. Bona verba 	0
allis. sed dico	Tibi ne temere 	0
e facias. neque	Haud tu dicas t	0
et hoc quod per	misit ad bonam 	1
 luxuriam. Sivi	autem distingue	0
i: cessavi sivi	antique. Aliter	0
e: et inexorabi	liter denuntiat	1
m vitam. Pro di	versam: et cont	1
 et contrariam:	sic Virgilius. 	0
us. Diis aliter	visum est.	0
c postulo: sive	aequum et ceter	0
. Gravius illud	fecit nomine ap	0
ine appellando.	q Ut redeat iam	0
deat iam in. v.	Iam: modo tardi	0
 tarditatis est	signum: et in v	0
 et in viam di-	xit: quasi exin	1
 exinde ius sit	erroris ad rect	0
ad rectam viam.	Ut redeat iam i	0
at iam in viam:	proverbiale.	0
proverbiale.	q Hoc quid sit.	0
quid sit. Deest	enim quaeris.	0
enim quaeris.	r Ita aiunt. Ha	0
nt. Haec et lo-	quuntur univers	1
niversi: et est	tepida consensi	0
sensio: et qua-	si inviti respo	1
onsio: ut in he	autonti. Ita cr	1
Ita credo monen	te patre filium	1
e patre filium.	s Tum si quis m	0
quis magistrum.	Metaphoricos. a	0
oricos. an quia	ex paedagogo es	0
m. Id est super	eam rem: hoc es	0
 est super amo-	rem. u Ipsum an	1
sum animum. ae.	Pro aegro. nam 	0
m animus aeger:	corpus aegrotum	0
 dicitur. x Non	hem. Interiecti	0
ectio est. ira-	scentis: y Davu	1
is: y Davus sum	non oedipus: Mu	0
: Multiplex con	tumelia. potest	1
test enim senem	quasi sphingam 	0
gam dixisse. id	est deformem mo	0
 monstrique si-	milem: potest e	1
st etiam inhuma	num et ferum di	1
erum dicere: ut	sphinx: potest 	0
etiam per oedi-	pum se ultorem 	1
 promittere fu-	turum: atque op	1
que oppressorem	sapientiae seni	0
enis. Davus sum	non. oe. facete	0
cete se negavit	oedipum: ut sen	0
nem sphinga es-	se confirmet no	1
et non oedipum.	Imitationum duo	0
num duo sunt ge	nera: quandam n	1
ecessitas: quan	dam introducit 	1
t voluntas. Non	oedipus: si lat	0
atine pronunti-	es genitivum oe	1
 oedipi faciet:	si graece oedip	0
aece oedipodis.	z Sane quidem. 	0
quidem. Sane va	lide: quia qui 	1
a qui sanus est	validus est. a 	0
s est. a Si sen	sero. h. quicqu	1
cquam. Commina-	tio et sic pron	1
ronuntiatio: ut	singulis verbis	0
 verbis ardeat:	mire hodie: nam	0
: nam ad tempus	non plenum: sed	0
m: sed ad commi	nationem refert	1
fertur: ut Vir-	gilius. Omnes h	1
 Omnes hodie mo	riemur inulti: 	1
ti: et dies pro	nocte accipitur	0
e. m. in. b Quo	fiant minus. Qu	0
editius. c Ver-	beribus te caes	1
e exagitare com	minatione servu	1
t ad perpetuum:	damus et amicis	0
ibus: e Ea lege	atque omine. Le	0
vinam refertur.	id est firmamen	0
em est quicquid	ore dicitur. Ea	0
ine: quia leges	auspiciis serva	0
: quasi dixerit	ea condicione: 	0
one: et antiqui	auspicato omnia	0
 rata esse vel-	lent.	1
lent.	f An nondum eti	0
n nondum etiam.	Quartum parelco	0
 parelcon: quia	abundat etiam.	0
abundat etiam.	g Ipsam rem mod	0
sam rem modo lo	cutus. Ipsam re	1
sam rem. id est	voluntatem suam	0
tatem suam: aut	hoc est pistrin	0
istrinum et poe	nas serviles.	1
nas serviles.	h Nihil circuit	0
ircuitione. Nil	pro non:	0
pro non:	i Circuitione. 	0
ione. Periphra-	si.	1
si.	k Usus es. Legi	0
 es. Legitur et	usor es.	0
usor es.	l Ubi vis facil	0
s facilius. Ad-	monitio. Ubi vi	1
 Ubi vis. Cice-	ro. Non est in 	1
n hac causa lo-	cus peccandi.	1
cus peccandi.	m Bona verba qu	0
a verba quaeso.	Hic	0
Hic	quasi	0
quasi	dicat meliora l	0
eliora loquere.	Rogo te ergo cu	0
te ergo cum ad-	monitione. bona	1
one. bona verba	inquit rogo.	0
inquit rogo.	n Nil me fallis	0
e fallis non te	ignoro. Non me 	0
lis figura	Fal-	0
pro etiam nunc.	o Neque huius t	0
 huius tu dicas	tibi non praedi	0
raedictum: duae	negativae faciu	0
ae faciunt unam	consentivam: tr	0
am: tres negati	vae pro una neg	1
una negativa ac	cipiuntur: ut h	1
 hic neque haud	non. Salustius.	0
stius. Haud im-	pigre neque inu	1
e inultus occi-	ditur. Vera erg	1
era ergo lectio	est: neque haud	0
e haud tu dicas	quod plurimi no	0
unt. Neque haud	tu dicas tibi n	0
que haud dicas:	subditiva glori	0
pidum arbitror.	diei festi patr	0
ictam ecclesiam	post eum maximu	0
um et multierum	unanimiter clam	0
ocibus postulan	tium balsami an	1
mcumque particu	lam nimirum qua	1
 eo unctus fue-	rit quin statim	1
 dubium fiat De	inde ad praedic	1
suis suffragane	is episcopis pa	1
nitatibus pasca	libus praeparat	1
us laudibus pau	latim expandunt	1
to et cum tremo	aurea iuxta alt	0
e Cui adhuc fi-	gura et int vol	1
permanet qualis	fuerat dei ince	0
s vero eius tam	quoque duritiam	0
uc sibi quae fu	erat cum ipse p	1
 deposito atque	in kathedra cor	0
inuo sacri mini	stri diei praec	1
ucharistia tem-	pus percipienda	1
tias patriarcha	in patena aurea	0
verentia ad lo-	cum ubi apostol	1
urvatis genubus	ipsas offert. I	0
creatoris exten	ta manu dextra 	1
non mortuus sed	omnino vivens e	0
et in palma con	servat singulas	1
sus namque fide	lium populus vi	1
entia atque for	midine unus pos	1
uli singulas ho	stias de manu a	1
quod porrigente	sed culpam tunc	0
bet quamquam et	crapula et dele	0
i crimine saepe	carent et possu	0
lui paenitendo.	¶ Propositio se	0
ropositio sexta	Pollutio corpor	0
ntingere potest	non solum sine 	0
raecedente immo	et ex merito. p	0
famosa gregorii	Et alios tam th	0
es. evenit enim	nonnumquam haec	0
 aut debilitate	naturae exonera	0
nere non valen-	tis Nam est pra	1
s fere talis in	iuris aliquibus	0
in menstruis et	fit cum nulla v	0
etiam vigilando	Fit insuper ali	0
anta lubricita-	te et facilitat	1
minis quod solo	affatu vel allo	0
ione provocatur	Quis ergo dixer	0
 renitentes aut	nullo modo cons	0
m peccatum mor-	tale committi N	1
lexionis harmo-	nia. quosdam vi	1
asione defluere	sanguinem. Alio	0
 illud non pati	scimus. Cognovi	0
m saecularem et	valde crapulosu	0
pollutum dormi-	endo testabatur	1
um vidi religi-	osum et sobrium	1
fere cottidiana	hac passione ve	0
mniant dormien-	tes. alios somn	1
 hoc et similia	et tam pudendam	0
is qui cum pos-	sit hoc prohibe	1
istimandus est.	Numquid enim no	0
 gloriam a sum-	mo deo magnates	1
flagitium silen	tio transeant? 	1
er tolerent? ra	ptores et latro	1
passim cottidie	circumvagari si	0
adant. innocen-	tes opprimant. 	1
anibus capiant/	constringant/ t	0
 fuit officium.	ut ab arcium su	0
uderent/ a ter-	ris et patria i	1
erminarent. sor	didos istos can	1
 et effeminatos	innocentum flam	0
ortores. Ne mi-	hi succenseatis	1
ubernatores/ ob	secro. Visum en	1
relam hanc popu	larem esse. et 	1
tatum continge-	re. Ideo iuste 	1
isse. nunc prae	sertim cum maxi	1
 nemo quorum in	terest ea vobis	1
o uticensis cum	nimiae taciturn	0
ondit. Ego vero	tunc demum hanc	0
m abrumpam. cum	talia dicere va	0
 taciturnitate.	Quocirca cum op	0
eat bonis mori-	bus iustitia/ c	1
risque virtuti-	bus esse praedi	1
illorum offici-	um ut ecclesias	1
neant clerum de	fendant. orphan	1
e praedationes/	violentias/ ac 	0
erceri prohibe-	ant. Cumque per	1
 qui haec offi-	cia principibus	1
am sancta. quam	iucunda foret e	0
arum accomodati	patriae rectori	0
 vita principum	concinnati. und	0
sent imitari et	quae vitanda su	0
deoque Demetri-	us/ Phalareus/ 	1
lebat ut libros	a iiii	0
a iiii	singulas domos 	0
stiae: pacifice	per oblationem  0	
s partes distri	buebantur. quar	1
norem dei. alia	pars erat sacer	0
ferentium et ea	vestebantur in 	0
uam cibo conse-	crato ut habetu	1
attestatur con-	suetudo valde u	1
sis dioecesibus	ubi specialiter	0
ntiam communica	tonis spiritual	1
. quatenus occu	patio magis ass	1
m sumptionem et	omnia participe	0
ea consecrantur	quae deserviunt	0
. vasa. mappae.	Propositio iiii	0
Propositio iiii	Secundae observ	0
 fiat quo expo-	sita est. est i	1
 superstitiosa.	Haec propositio	0
 huius materiae	praemisso. Nam 	0
ex florida phan	tasia alicuius 	1
s aliquid conse	qui per aliqua 	1
 talis effectus	non est natus p	0
 practica huius	secundae observ	0
enali septimana	ponuntur scapul	0
vel includuntur	in altaribus et	0
passiones. iiii	evan. scilicet 	0
T..V. III.	peccatoris quod	0
veatur: quod fi	eri non potest 1	
in quo operatur	vertus passioni	0
tionem sacerdo-	tis simul cum o	1
i cooperatur ad	destructionem p	0
Augus super Io.	Qui creavit te 	0
ficabit te sine	te. unde patet 	0
est necessarium	ad salutem post	0
medicina corpo-	ralis postquam 	1
culosum incide-	rit. hoc Tho. 3	1
84ª. ar. 5º. c.	Ergo tur videre	0
 de institution	ne principiae. 	1
r quando. quon.	ubi. et a quo s	0
um sacrorum pe-	nitentiae. ergo	1
de dictamine le	gis naturae: qu	1
o conteri et hu	miliari debet c	1
 illustratione.	et sic tale sac	0
inuationem quam	institutionem. 	0
 dictabat: insi	nuare sufficieb	1
inus insinuabat	quando post pec	0
vit genesi. 3º.	ubi dicit glo. 	0
um ad cor redi-	re: iuxta illud	1
e praevaricato-	res ad cor. Ali	1
ncipia secundum	quod est sacror	0
ionem haec a le	ge scripta: siv	1
 evangelica. In	lege mosayca: q	0
t veritas pate-	facta: nec reco	1
nstitutionem ha	buit secundum i	1
tum ad generali	tatem in determ	1
: quae erant lo	co confessionis	1
. In lege autem	nova ubi verita	0
t reconciliatio	perfecta et ple	0
um statum perfe	ctionis: et qua	1
d est absolutio	sacerdotalis: e	0
riale: quod est	lucida et apert	0
stituit per se:	et promulgavit 	0
Mather. 16º. et	Io. 20. 2sed ve	0
ostolos: vel ut	melius dicam pr	0
us apostolos do	cuit: et ipsi a	1
ctoritate ab eo	accepta: immo e	0
promulgaverunt.	non enim nobis 	0
 ipsi a domino:	vel a spu domin	0
s. 4º. di. 22ª.	q. 2ª. ar. i. c	0
praedicta de in	stitutione patr	1
rincipia insti-	tuta est quantu	1
iorem a lege na	turae: et quant	1
iorem a lege mo	sayca: quae pra	1
quaedam sacrifi	tia: sed quo ad	1
atum in utroque	a lege nova: qu	0
ionem et satis-	factionem ad ar	1
is faciendam et	facere. Ad hoc 	0
od sit sacrorum	et causa remiss	0
e. 4º. di. 22ª.	q. 2ª. ar. 4º. 	0
crorum principe	immediate fueri	0
 secundum omnes	partes suas. An	0
istus instituit	hoc sacrorum qu	0
ntritionem peni	tentis: et quan	1
sfactionem. cum	dixit Luc. 5º. 	0
 dixit. Nisi pe	nitentiam aeger	1
itis. Luc. 13º.	Confessionem au	0
mplo. cum dixit	leproso. Vade o	0
ti. Mather. 8º.	Absolutionem au	0
licet in Lazaro	resuscitato. cu	0
m. Io. iiº. sed	expresse non de	0
bsoluendi usque	post responrect	0
 ut haentur Io.	20. Accipite sp	0
ec. remit. eis.	Ante vero ptant	0
totam ecclesiam	promisit se dat	0
um dixit ei. Ma	tthe. 16º. Tibi	1
gni celorum. et	quodcumque liga	0
men tunc dedit.	unde decretum A	0
. in novo testa	mento: exponend	1
atum ptantem iu	risdictionis: s	1
endi et ligandi	in foro patriae	0
ctionem cum ali	is discipulis a	1
tas iurisdictio	nis super totam	1
a fuit data pro	se et successor	0
ic. 5ª. di. con	siderandum. et.	1
elec. significa	sti. hoc Ric. 4	1
. o. sed de hoc	vide. jua. ti. 	0
ssionis quid di	cat Scotus. 1
cat Scotus.	¶ De quibus pri	0
um de quibus pe	nitentia debet 	1
 circa hoc quae	runtur potesta.	1
m principia sit	agenda de pecca	0
e facto proprio	et voluntario. 	0
 est factum pro	prium: nec volu	1
uae sit in ipso	sed in altero. 	0
non requiritur.	In adulto tamen	0
rato requiritur	displicentia ei	0
ibet mali. ideo	dicit Augus li.	0
onem pro origi-	nali est arguen	1
illo velit per-	manere. hoc Pet	1
ante baptismum.	¶ Utrum de prae	0
ossunt etiam in	ista pares esse	0
is D omnino non	possunt M recte	0
gura melior vi-	deatur et pulcr	1
 D nescio utrum	quispiam non pr	0
ura quae tribus	angulis peribus	0
 contrarium. id	est ex altera p	0
ngulus D lineam	video M quid er	0
et linea lineae	contraria sit. 	0
em in ea figura	in qua id accid	0
 id fiat tribus	lineis omnino n	0
. potest ne hoc	fieri D prorsus	0
lineis rationis	paribus quam qu	0
dem magis in ea	equalitas valet	0
 rectis paribus	lineis confit. 	0
i ut non angeli	omnes in ea par	0
video posse. m.	quonam modo D s	0
ter. m. videsne	etiam quaemadmo	0
aperciores sibi	contrarii sint 	0
 servatam id et	hoc quanta serv	0
s enim profecto	fieri non posse	0
a perficiur non	aut omnes aut c	0
missimae teneo.	m. Nihil ne te 	0
us tanta et tam	inconcussa quae	0
. quia nihil ut	arbitror dicimu	0
quitas autem ab	equalitate quad	0
virtute equitas	nisi ut sua cui	0
que nisi quadam	distinctione tr	0
as D mainfestum	est et prorsus 	0
itraris nostrae	vlla si omnia p	0
 eo quod absque	usu liberi arbi	0
m. cuius est ef	fectus vel sign	1
denti negligen-	tia praeparatio	1
t esse peccatum	vel mortale vel	0
a demonum volen	tium impedire h	1
s scilicet cogi	tatio praeceden	1
i assit consen-	sus erit patrri	1
doque at potest	esse sine omni 	0
atur de talibus	cogitare. Et si	0
cogitatio immun	da. sed honesta	1
seca et corpora	lis. vicem supe	1
vel potus. quae	quandoque est c	0
uitate cibi vel	potus. Quoniamq	0
urae. Si igitur	pollutio ex ali	0
icet polluto ce	lebrare nisi po	1
cite celebrare.	Verum tamen si 	0
tas vel vitatio	scandali urgeat	0
proveniat. Ideo	in dubio tutius	0
 vel devoto spe	cialis instiget	1
ns assit. ¶ Ita	sentiendum ver 	0
gilia finiatur.	Nisi quis post 	0
delectatione et	cum appetitu fu	0
ius abstinetur.	¶ Articulus. te	0
ntudinem mentis	ipsius ministri	0
pam et gratiam.	¶ Dubium primum	0
io misericordia	¶ Somni. Cum ad	0
d perfectio il-	la fit peractum	1
tur et specifi-	catur. constat 	1
crorum exigitur	intentio mistr.	0
is tantu facis.	Dubium. secundu	0
intendere sacer	dos consecrare 	1
onformare inten	tioni ecclesiae	1
n huiusmodi est	minster. Intend	0
nssubstantiavit	panem in corpus	0
et intendere sa	cerdos. ¶ Dubiu	1
ionis naturario	requiratur. ant	0
 Intentio actua	lis non necessa	1
entio virtualis	cum quis prius 	0
d consecrandum.	posito quod act	0
nim manet inten	tio prima. et h	1
are debet sacer	dos ut est actu	1
tiam deesse non	Conscientia Deb	0
ratia ad tantum	sacramentum acc	0
 affectum ratio	Habes ne inspir	0
titiam ut intel	ligas quoniam t	1
 esse inspiret.	Consciam Non al	0
entio me ad com	munionem dulcit	1
ci. credo hoc o	pus esse divina	1
 enim puto quod	diabolus hoc im	0
am si certo sig	no cognosceres 	1
aret. non tamen	deberes expecta	0
aret hoc signum	ubi enim secund	0
em habetur quid	agendum sit. ib	0
ionis perversae	est. et deum te	0
s igitur expec-	tanda est inspi	1
llax habetur et	nulla penitus c	0
um sit diabolum	in irreverentia	0
munionem quate-	nus et deum inh	1
 sibi manducent	et bibant. An c	0
nime crediderim	haec. sed verbi	0
dubio quod peni	tus ignoro quid	1
. hactenus enim	habui pro signo	0
rem. quod in me	sensi aliquid d	0
quando illud in	me non repperi.	0
n hoc veritatis	sit. vel errori	0
bere desiderium	aliud sensibile	0
et accentus re-	gularis. ut sor	1
r id sortes cur	rit et ipse mov	1
 Luca. qui fuit	Iacob qui fuit 	0
ri nomina et ad	verbia inceptiv	0
unc faciunt re-	lationem explic	1
ur ad ostenden-	dum hanc vim. Q	1
runtur clausule	sui antecedenti	0
ationem implici	tam. et tunc tr	1
. et ideo amit-	tunt naturalem 	1
i. Et habet lo-	cum praedicta d	1
minibus interro	gativis et adve	1
ossunt. ut qua-	lis quamtus quo	1
quo qua unde et	ubi. quoniam cu	0
 quoque distin-	ctio causa quar	1
 acuunt antepe.	ut exinde deind	0
quae est licen-	ga positione ac	1
lam. Priscianus	autem det hoc p	0
 sic accidit in	aliquibus adver	0
 ne praepositio	videatur venire	0
ed eadem ratio-	ne composita ab	1
et ab orsum. ut	deorsum. sic de	0
 quod omnes con	cordant quod in	1
nde. et ceteris	compositis ab i	0
uatur. Et simi-	liter a quando 	1
ndo nequando et	aliquando. In a	0
mnes concordant	ut abintus dein	0
elonge deorsum.	et desursum. de	0
 Ideo de quando	et inde indubit	0
uod ab eis con-	posita debent i	1
tera autem sunt	regulariter pro	0
ter conformita-	tem tenendam pe	1
 bibliam. ut ta	lia etiam non a	1
ntur. Qui autem	corrigit non mu	0
d potius dissi-	mulet. quia hoc	1
. scilicet Pri-	sciano nisi de 	1
 et ab inde. Ut	etiam adverbia 	0
s distinguantur	contra quartam 	0
adverbia ultimo	acuuntur alio a	0
 Causa etiam di	stinguendi prae	1
nt accentus su-	os. de quibus t	1
Prima est. quod	praepositiones 	0
ur in fine. sed	quando ponuntur	0
ut ad quae pars	est. Secunda re	0
 praeposite suo	casuali (ut ext	0
 portam) vel in	terposite suis 	1
am extra domum)	vel praeposite 	0
uum casuale (ut	extra mundi ter	0
ntur in omnibus	syllabis Tertia	0
positiones post	posite casibus 	0
 posite per de-	fectum verborum	1
multis nati so-	lus super id su	1
ne. ut mille ho	mines venere su	1
lem regulam. ut	scilicet monasy	0
laba dictio acu	at primam. et t	1
 si me. est bre	vis acuit ante 	1
nibus supradic-	tis. Haec praep	1
osita accusati-	vo trahit ipsum	1
m adverbium lo-	cale. secundum 	1
et tunc acuitur	pe. vel dicatur	0
t versus incli-	nat accentum pr	1
d hanc syllabam	ver et omnes al	0
ur. sive circum	flectitur. et e	1
ausa distinctio	nis variant acc	1
te gravantur in	omnibus syllabi	0
rrit igitur mo-	vetur. postposi	1
entum regularem	ut sortes curri	0
hoc praeter en-	cleticas. quae 	1
nt quaemadmodum	si praeponerent	0
is accentus co-	git accentum in	1
ndoque corripi.	ut meimet grava	0
ga propter prin	cipalem accentu	1
uando dicebatur	mei quem non po	0
labica adiectio	Et sic tene de 	0
et illemet. Sic	in imperativo d	0
calefac. ponen-	tes accentum su	1
 principalis ac	centus in integ	1
eam. Sic vultei	pompei et virgi	0
t. de quibus di	ctum est. Item 	1
 super hanc sil	labam li. in ho	1
o metrici utum-	tur tamquam tri	1
cui antepenlis.	sed prosaici eo	0
rasyllabo. ideo	ponunt accentum	0
ent pro antepe.	De interiection	0
est dari certum	documentum. nec	0
si hoc quod Om-	nis barbara vox	1
tinae. accentum	super extremam 	0
riectiones quo-	que in fine sep	1
c. terminata di	cunt quidam in 	1
 allecis. De be	nefac praedic e	1
 non est dubium	de allec satis 	0
 donec non for-	te sic. Interea	1
one computatur.	et ut tollatur 	0
 sermone profe-	ratur sub uno a	1
r antepenlis In	libro accentuum	0
. quod adverbia	in e. terminata	0
s. ut hodie se-	dule. quae a pr	1
ucuntur. ut Tul	lianae Martiana	1
ucuntur. ut mea	tim tuatim. Si 	1
 ut vesperi. Si	in o. cas diffe	0
ant accentum ut	falso. Si in a.	0
utetur esse no-	men. Si in as. 	1
alias. ne nomen	esse videatur. 	0
 brevitur Si in	ol similter. ut	0
imo servant ac-	centum. ut illi	1
Liber. II.	¶ Incipit liber	0
ecundus de cano	nico nocturnaru	1
um orationum et	psalmorum modo.	0
. ¶ Ca. primum.	Duplici 0
Duplici	igitur hoc quod	0
 hoc quod dixi-	mus cingulo chr	1
us cingulo chri	sti miles accin	1
miles accinctus	interim qui mod	0
terim qui modus	canonicarum ora	0
canonicarum ora	tionum psalmoru	1
rtibus orientis	a sanctis patri	0
quitus statutus	agnoscat. De qu	0
ro eam vel quem	admodum orare s	0
sententiam sine	intermissione p	0
in locus cum se	niorum collatio	1
erimus exponere	quantum dominus	0
erit proferemus	¶ De diversitat	0
e numeri qui ad	decantandos psa	0
psalmos per uni	versas provinti	1
s sit statutus.	¶ Capitulum. ii	0
 Capitulum. ii.	Ultos namque co	0
perimus per ali	as regiones pro	1
entis suae capa	citate. habente	1
s quidem ut ait	apostolus creel	0
m. super hac re	diversos typos 	0
sibimet consti-	tuisse. Quidam 	1
os seu tricenos	psalmos. et hos	0
tione quarundam	modulationum. d	0
singulus nocti-	bus censueret. 	1
m etiam excede-	re temptaverunt	1
 decem et octo.	atque in hunc m	0
institutum. tot	que propemodum 	1
regulas vidimus	usurpatas. quot	0
teria cellasque	conspeximus Sun	0
ipsis quom diur	nis orationum o	1
a sexta nonaque	id visum est. u	0
modum in quibus	haec domino red	0
quia. psalmorum	etiam et oratio	0
numerum coequam	dum. nonnullis 	1
 senarium nume-	rum singulus di	1
tibus deputari.	Quapropter nece	0
eor antiquissi-	mam patrum prof	1
constitutionem.	quae nunc usque	0
yptum a dei fa-	mulis custoditu	1
elli monasterii	in christo rudi	0
antiquissimorum	potius patrum v	0
institutionibus	imbuatur. ¶ De 	0
niformis regule	per totam aegyp	0
odia. et de ele	ctione eorum qu	1
 fratribus prae	ponantur. ¶ Cap	1
ur. ¶ Cap. iii.	Taque per unive	0
egyptum et the-	bayden. ubi mon	1
asteria non pro	uniuscuiusque r	0
untiantis insti	tuuntur arbitri	1
ssiones ac tra-	ditiones maioru	1
 hodiernum diem	vel permanent v	0
fundantur. legi	timum orationum	1
 in vespertinis	conventibus seu	0
 vigiliis vidi-	mus retentari. 	1
isquam conventi	culo fratrum. s	1
praesenesse con	ceditur. priusq	1
ersis facultati	bus suis reddat	1
i quidem ipsius	se esse dominum	0
bere cognoscat.	Ita namque renu	0
 huic mundo qui	buslibet facult	1
tiis praeditum.	necesse est cen	0
ationem expete-	re. ut in nullo	1
ae reliquit aut	intulit monaste	0
ur. sic obedire	cunctis ut rede	0
ndum sententiam	domini ad infan	0
 noverit. nihil	sibi considerat	0
l annorum nume-	rositate praese	1
o inanitur con-	sumptam se repu	1
. sed pro rudi-	mentorum merito	1
i novitate quam	se gerere in ch	0
ecognoscit. sed	dare se etiam i	0
moretur. Operis	quoque ac sudor	0
 ita subire com	pellitur. ut pr	1
apostoli praece	ptum quotidianu	1
vel suis usibus	vel advenientiu	0
bus praeparans.	fastus vitae pr	0
 et delitias ob	livisci. et hum	1
 contritione la	boris acquirere	1
 nullus congre-	gationi fratum 	1
itur. priusquam	idem qui praefi	0
. quid obtempe-	raturis oportea	1
obediendo didi-	cerit. et quid 	1
 tradere debeat	institutis seni	0
t assecutus. Be	ne enim regere 	1
ientis esse pro	nuntiant. summu	1
 gratiam sancti	A 4 0
e sancto Andrea	Fo. III.    0
en cogitationes	nostrae et oper	0
s ante deum nos	fortitur accusa	0
allibilis. Tres	enim testes tun	0
ccator. Unum su	pra se haembit 	1
et testim. Hie-	re. xxix. Ego s	1
ium interim se.	scilicet consci	0
 times praesen-	tem conscientia	1
usae. testimoni	um est conscien	1
rium angelum ad	custodiam deput	0
ecit contra eum	testimonium per	0
unt celi id an-	geli iniquitate	1
atio peccatoris	de hoc sic dici	0
tunc viae repro	bis. Superius e	1
erius horrendum	chaos. A dextri	0
nistris infini-	ta demonia ad s	1
nscientia vrens	foris mundus ar	0
rehensus quo fu	giet. laterae e	1
olerabile. Octa	vum est enim ir	1
uam poterit re-	vocari. nec ab 	1
riplici enim de	cem appellatio 	1
ecipitur. Primo	propter iudicis	0
ege ferente sen	tentiam appella	1
: quia in regno	suo nullum supr	0
eratore vel pa-	pa patet appell	1
iminis evidenti	am. quia quando	1
test appellari.	Tertio propter 	0
res non recipit	dilationem (qui	0
ntum pateretur)	Similter non ap	0
 rationem ab il	la sententia. N	1
o propter iudi-	cis excellentia	1
habet: sed ipse	omnes excedit e	0
entate. unde ab	imperatore vel 	0
appellari ad de	um: a deo autem	1
t: quia secundo	propter crimini	0
lera et crimina	reproborum ibid	0
ta. Hiero. Ade-	rit illa dies i	1
am tabula picta	demonstrabuntur	0
non differendam	nihil enim quod	0
 omnia in momen	to in ictu ocul	1
uli peraguntur.	ANdreas interpr	0
Ndreas interpre	praetatur decor	1
s. vel virilis.	ab andor quod e	0
ur andreas quia	antropos id hom	0
tropos quod est	conversio. quas	0
sus. et ad suum	creatorem erect	0
espondens in sa	pientia et doct	1
antropos in glo	ria. Eius passi	1
nes achaiae seu	asiae sicut ocu	0
conscripserunt.	ANdreas et qui  1
ANdreas et qui	dam alii discip	1
icibus a domino	sunt vocati. Pr	0
ius vocavit eos	ad sui notitiam	0
 a iohabe. Ecce	agnus de etcra.	0
nt et vidit ubi	manebat iherus 	0
llo. Inveniens-	que andreas fra	1
edierint. Post-	modum secundo v	1
liaritatem. sic	cum quadam die 	0
xta stagnum ge-	nazereth quod d	1
 intervit symo-	nis et andree. 	1
gna piscium. vo	catisque iacobo	1
avi secuti sunt	eum. et item ad	0
tertio et ulti-	mo vocavit eos 	1
uando anbulante	ihesu iuxta ide	0
ecuti sunt eum.	eique semper po	0
 propria redie-	runt. Nihilomin	1
quosdam de suis	disciplis ad ap	0
ur Mar. iij. vo	cavit ad se quo	1
 eum. et fec ut	esset. xii. cum	0
s apostolis an-	dreas apud scit	1
stol murgundiam	praedicavit. vi	0
i penitus respu	entes. ei oculo	1
rceraveret post	paucos dies occ	0
. Interea ange-	lus domini sanc	1
urgundiam ad sa	nctum matheum i	1
m nescire. ius-	sit ut ad ripam	1
 navem quam in-	veniret: intrar	1
s ad urbem prae	dictam veint an	1
ante. et inven-	to aperto carce	1
 flevit polimum	et oravit. Tunc	0
 bonficium duo-	rum luminum. qu	1
a peccatum. Ma-	theus autem abi	1
chiam venit. An	drea quoro murg	1
i illi de evasi	on santi mathei	1
nt. et per pla-	teas ligatis ma	1
ius sanguis ef-	flueret pro eis	1
atione eos con-	vertit: inde in	1
ue quod dicitur	de hmoni orbati	0
tione duorum lu	minum per andre	1
ei. ne in tanto	evangelista min	0
tur quasi sibi.	non potuerit ob	0
i tam facile im	petravit. Quida	1
 dum invitus pa	rentibus aposto	1
us domum in qua	morabatur cum a	0
am in altu flam	ma succresceret	1
lla super ignem	aquam sparsit e	0
is autem dicen-	tibus filius no	1
calas vellent a	scendere adeo s	1
las penitus non	viderent. Tunc 	0
 quid vos stul-	to labore consu	1
. et vos non vi	detis: Cessate 	1
descendat. Mul-	ti ergo vidente	1



 vero eius post	quinquaginta di	0
non yayrus 77 C	Religio dicitur	0
um celorum 71 D	Reliquit eunum 	0
m diabolus 29 N	Remittere debem	0
s ex corde 75 Q	Res convenire d	0
 temporari 78 A	Resplenduit fac	0
 sicut sol 30 F	Responsum datur	0
 quaerenti 25 F	Resurrectio chr	0
lis fuerit 35 L	Resurrectio chr	0
fuerit ibidem m	Resurgens chris	0
ubi fuerit 35 N	Resurrecionem s	0
at dominus 37 E	Resurectionis c	0
isti signa 41 D	Resurgentes an 	0
indigeant vesti	bus 41 E    0
bus 41 E	Resurrectionis 	0
hristi octo op-	portunitates 41 1	
rtunitates 41 F	Resurgens chris	0
ervavit cicatri	ces 42 F    1
ces 42 F	Resurrectionem 	0
 suam quare non	distulit dominu 	0
it dominus 44 B	Resurrexit domi 0	
die tertia 44 C	Resurgens apper 0
 quadraginta di	ebus 44 D   1	
ebus 44 D	Resurgens apper	0
isdictionem eis	ut placet et li	0
entationem sive	per alium modum	0
atorum quousque	fuerit ecclesii	0
 ¶ Item sanctum	Tho. in 4. di. 	0
rium sacrodotem	esse haertticum	0
alum aut fragi-	lem ad peccatum	1
r et pronum vel	si probabiliter	0
essionum vel si	patet de quo qu	0
ommissum contra	eum. In hiis et	0
et penitens pro	babiliter ex co	1
ericulum immin-	ere. debet recu	1
icentiam alteri	confitendi. qua	0
 possit idem iu	dicium esset si	1
iam confessorum	Idem tenent pe.	0
confiteatur pec	catum in genera	1
 ¶ Item sanctum	hosti. vagabund	0
lium quo se con	ferant possunt 	1
nt absoluere et	audire confessi	0
quis intraturum	est iustum bell	0
dos pter alteri	confiteri sine 	0
nt peram et ba-	culum a proprii	1
eorum item arri	puerint. praesu	1
 medicus sanans	vulneratum: ut 	0
icatum Ipse ha-	betur ibi ut do	1
i sententiam re	laxans et miser	1
otens exaltans.	et defendens. u	0
is petitionibus	et miseriis con	0
icam. sicut est	omnia ni omnibu	0
icet unicus sit	est tamen multi	0
ricordia. Et ne	tua interrogati	0
nterrumpas. vl-	tra debes scire	1
te esse Nam cum	tu in deus sis.	0
ias Et licet de	deo nullam poss	0
 tamen quia per	similitudinem r	0
. ideo pono pro	similitudine qu	0
 tamquam formam	vel vas aliquod	0
tur infundi. et	deum tamquam li	0
asi. sive forme	infundendum Ita	0
us sive tua ne-	cessitas sit fo	1
i suscipiens ut	ita dicam impre	0
odum tuae forme	idest necessita	0
n quod ipse sic	mutetur sed qui	0
 remedium omni-	um infirmitatum	1
 omnis implecio	affectuum nostr	0
hoc igitur quod	tu exhibueris o	0
tionis tuae vel	necessitatis se	0
litate si tamen	qualitas dici d	0
debit affectui.	id est remedio 	0
uippe omne iudi	cium dedit fili	1
 conspectu suo.	cadens super ge	0
tem lamentas et	peniteas. ipse 	0
men futurum non	reservabit. Put	0
¶ Sacerdos. Ne-	scio. Quia ei c	1
bitur. eciam iu	dicium et iusti	1
et deo. ¶ Ponti	fex. Nunc bene 	1
 Sed mea et tua	tibi dicta decl	0
dimittere debi-	toribus nostris	1
icors. sed quia	iustus est dece	0
tibi in virtute	bonitatis suae.	0
aesentiae tanti	hospitis. Certa	0
um vapor nebule	sic ad suam pra	0
a dissolventur.	Et sic iuxta om	0
et necessitatem	potes meditari 	0
us qui habet in	genta ad omnes 	1
 ¶ Sacerdos. Tu	dicis ut acceda	0
am. ¶ Pontifex.	Obligatus es de	0
 celebra missam	et offer sacrif	0
m et exaudit te	si tamen expedi	0
quia non conve-	nit omnibus quo	1
. Apostolum non	exaudivit pro a	0
nis. Sed certi-	ssime scias si 	1
 illo. exaudiet	te tamen aliud 	0
ibi expedierit.	Vel dilationem 	0
ua. Quinta arbo	res et herbe da	1
 die ut alii as	servunt omnia v	1
queque genus in	ordinae suo. no	0
cis formidantia	Sexta ruent edi	0
lmina ignea sur	gent ab occasu 	1
um concurrentia	Septima petrae 	0
sonum illum sed	tantum deus. Oc	0
solum omnia pro	sternentur. Non	1
 in pulverem re	digentur. Decim	1
 velut amentes.	nec mutuo sibi 	0
rum. et stabunt	super sepulcra.	0
ccasum solis a-	perientur ut in	1
 stellae. omnia	enim sidera err	0
 comas. et item	tunc valde gene	0
nia animalia ve	nient ad campos	1
a. Tredecima mo	rientur vivente	1
a ardebit celum	et terra. Quint	0
resurgent omnes	¶ E Secundum qu	0
acia. Ipse enim	omnes decipere 	0
 suasionem sive	scriperturarum 	0
e et ex scriptu	ra firmare se e	1
hristi destruer	et suam statuet	1
et cetera. glo-	sa id est anthi	1
dabunt abomina-	tionem et desol	1
plo dei sedebit	quasi deus ut l	0
lorum operatio-	nem ii. thess. 	1
 sathanae in om	nibus verbis et	1
ii. Fecit signa	ut etiam ignem 	0
t apostolis da-	tus est spiritu	1
iritum malignum	in spirituae ig	0
i. Dabit eis po	testatem in mul	1
ristus deceptis	bona multa dabi	0
suo terrore sub	iugare non pote	0
oquens de anthi	cristo. Robusto	1
ti sunt corpora	liter vincit.	1
gnis vehementia	qui quidem prae	0
em emittet deus	Primo propter m	0
cuartur. cervix	excitata deponi	0
tibus suspiriis	pectus vigitur 	0
 loquentis ver-	ba anhelitus de	1
c languor defi-	cit senibus ips	1
tudo est. unde.	Virgilius. nome	0
ati imposuit et	vocavit tristis	0
arto ibidem Non	est gloriandum 	0
tute etatis. ni	si assit senect	1
t virtutis ut a	it Seneca eplam	1
 ut diu vivamus	curandum est. s	0
gam est vita si	plena est. impl	0
 cum animus si-	bi suum bonum r	1
d se potestatem	sui transtulit 	0
uinto ibidem Ca	veat ergo senil	1
particule iuve-	nescentes totam	1
decipiant. et u	nicuique etati 	1
. quod etati im	minenti dignum 	1
ceret; non erit	dignum puerilia	0
atione revocare	¶ De sexto ibid	0
Senes sciant se	non habere anno	0
ierunt et se de	bent habere pro	1
annos habeo hos	Nos inquit dice	0
eponentes vitae	seculi onera mo	0
x autem ut haec	audivit ira max	0
que furore suc-	census edictum 	1
christianum co-	artari ut negar	1
 Unde novas qui	dem contra ipso	1
ies tormnetorum	excogitabat et 	0
rebant et novos	morcium modos m	0
entias per uni-	versas sibi sub	1
delegabat prin-	cibus atque dua	1
rsus pios et ne	ces iniustas de	1
aecipue vero ad	versus monastic	1
os furens atro-	cissimum contra	1
 excitavit bel-	lum. Tunc multi	1
nte commoveban-	tur alii vero t	1
re non valentes	execrabili illi	0
cepto. Monasti-	ci autem ordini	1
es palam quidem	atque in facie 	0
edarguentes per	martirium tempo	0
sortiebantur et	eternam acquire	0
m. Alii vero in	solitudinibus e	0
condebantur non	quod tormenta m	0
nsatione quadam	divina hoc ageb	0
itate vidiam oc	cupante et fide	1
idem undique re	pulsis impietat	1
mnia tenentibus	cruoribus et ni	0
 etiam ipso ae-	re iam inquinat	1
ars libri primi	censentur. Idem	0
amilia episcopi	laica. quia non	0
ic habet ius in	ea sicut cardin	0
ales. Sed si es	sent de diocesi	1
ipsa de eius li	centia confitea	1
 Si ant de alia	exquo eius hosp	0
imiserret. quia	per diocesim va	0
gantur respectu	illius diocesis	0
 vagabundi repu	tantur. ut de l	1
opi illius. vel	cuiuslibet cura	0
i: ad cus paro-	chiam veniunt c	1
ri possunt. Con	cordat in hoc s	1
 peregrini nego	tiatores et ali	1
iatores. si non	habent licentia	0
uis curatus vel	episcopis. vel 	0
ntia eorum iter	arripiunt non p	0
possunt absolvi	ab aliis Inno. 	0
ratione delicti	vi. q. iij. c. 	0
 quod quidam di	cunt esse verum	1
 quando propter	hoc est exconic	0
si esset exconi	catus a praelat	1
lius propter il	lud patriam. si	1
suevit fieri in	furtis et humor	0
orum ignorantur	autores: mitten	0
est talis ad ex	conicatorem abs	1
olvendus ab eo.	sed si patriam 	0
ium. et propter	hoc non sit exc	0
test de hoc con	fiteri proprio 	1
doti. ut der in	summa pisana. F	0
ranc. zaba. re-	fert Landul. te	1
ere quod curati	et etiam frens 	0
missi ad audien	dum confessione	0
m formam clemen	tine. dudum. po	1
nt audire et ab	solvere patam c	1
a. non solum in	diocesi. sed et	0
 extra territo-	rium diocesis. 	1
men confitentes	possunt illis c	0
uod sint illius	diocesset vel p	0
chiae quo ad cu	ratos ¶ Sextus 	1
¶ Sextus casus.	Sextus ratione 	0
studii. ut scho	lares etiam si 	1
on sunt moratu-	ri nisi per ann	1
o. vel quia non	habent plus de 	0
vel ab episcopo	vel capitulo de	0
us licentia ibi	sunt. vel quia 	0
sponunt. vel de	parochia in par	0
chiam mutantur.	De illud vero s	0
bus qui veniunt	de omni parte r	0
 ad perlamentum	parisius. cum r	0
putet se fiscum	non recognoscen	0
orem in toto or	be. videtur quo	1
ossint confite-	ri episcopo et 	1
uorum parochiis	domos conducunt	0
olim in tempore	imperatorum Rom	0
 erat ibi conis	patria. et quic	0
 illuc veniebat	habebat iudicem	0
licet praetorem	peregrinum. Sed	0
m scilicet quod	non possunt abs	0
ione perlamenti	si non habent l	0
suis praelatis.	quia rex parisi	0
abet ptantem in	spiritalibus. n	0
eteris partibus	regni. ¶ Episco	0
t in spirituali	bus soli suae d	1
. solum eius ro	ma ubi est sede	1
e in spirituali	bus omnibus est	1
 sicut ecclesia	cathedralem omn	0
e diocesi. unde	in curia romana	0
na sicut curato	suo summo patri	0
re spiritus san	cti consumuntur	1
lesiam spiritua	lem: quattuor e	1
tuor mundi pla-	gas per quas ec	1
t christum sine	quo munus nullu	0
t unde ecclesia	solet orationes	0
 Quiato signifi	cat corpus domi	1
. de parascephe	dicetur. Quinto	0
a cum discipuli	convivatus est.	0
 in archa testa	menti sive test	1
tio id est tabu	le in quibus sc	1
m quaedam repo-	sita ibi testim	1
ificatione quod	legem namlem in	0
taverat in scri	ptis. Reposita 	0
rea plena manna	in testificatio	0
s israel: de ce	lo: et verga aa	1
is ptans a domi	no deo est et d	0
onium pacti quo	dixerant. omnia	0
emus: et ob hoc	dicta est archa	0
am vero sanctum	est propitiator	0
o. iiii. partis	in cuius rei im	0
siis super alta	re collocatur a	1
 quo corpus do-	mini et reliqui	1
minus fieri can	delabus ductile	1
xo.xxv. legitur	et. iii. Respon	0
ud non est nisi	due tabulae lap	0
in ea moyses in	oreb quando pep	0
l cum egrediren	tur de terra ae	1
 silvestri pape	Constantinus im	0
 lateraneum. in	qua posuit arch	0
us imperator ap	portaverat de h	1
um cum. vii. in	fusoriis lucern	0
c: annuli et ve	stes aure tabul	1
ices cum quibus	tonsus fuit sci	0
omo si habet al	tare mensam can	1
est. omne siqui	dem eum altare 	1
 et recte divi-	dat. Altare est	1
s offerre. unde	in exo. praecep	0
fferes holocau-	sta: quia de co	1
e charitatis ac	censa. holocaus	1
t totum et cau-	sa quod est inc	1
i ex toto incen	sa. In isto igi	1
fferre et recte	dividere. recta	0
 quod cogitamus	ad perfectionem	0
e dividimus. si	non discrete il	0
tat homo facere	bonum et facit 	0
facit bonum: et	ex alia perte f	0
cat et destruit	sed tunc rectae	0
cimus non nobis	sed soli deo at	0
mne hominem hic	ut inde panes v	0
sam sacram scri	pturam intellig	1
asti in conspe-	ctu meo mensam 	1
nt me id est de	disti mihi scri	1
oniacam omne ut	hanc habeamus i	0
panes verbi dei	inde sumamus. P	0
dicitur hieremi	as. Parvuli pet	1
 frangeret eis.	Oportet etiam e	0
 bonis operibus	luceat. Candela	0
 est opus bonum	quod alios per 	0
o dicitur. Nemo	accendit lucern	0
 sed sua cande-	labus. Lucerna 	1
t bona intentio	quia christus d	0
lus vero est in	tentio. Non deb	1
ernam sub modio	sed super cande	0
nam intentionem	non debemus abs	0
 aliis in lumen	et exemplum mai	0
e eum etiam hic	dominum ab arce	0
sciplina vel re	gularis vita pe	1
rcentur. In ar-	cha autem sunt 	1
uia in regulari	vita debet esse	0
 castigetur: et	tabula dilectio	0
libus enim scri	pta sunt mandat	1
onem dei. debet	etiam ibi esse 	0
quam suavis est	deus gustemus e	0
 est negotiatio	eius. Iuxta ill	0
forti. Gustavit	et vidit quia b	0
 dei sumus habe	amus in nobis a	1
m ne apperiamus	in conspcum dei	0
on apparebis in	conspectu dei t	0
omnes mesam per	refectionem ne 	0
unii. Iuxta il-	lud evangelii. 	1
os deficient in	via candelabus 	0
m ne simus ocio	si. Iuxta illud	1
ocuit ociositas	exsta de renunc	0
mus sicut filii	belial id absqu	0
ciplina no. ne-	cessaria est. i	1
ite disciplinam	ne quando irasc	0
t aliis altaris	ornamentis in s	0
c altare ille e	dificat qui cor	1
 vertutibus ex-	ornat. unde Gre	1
itate congregat	quasi qui pulve	0
altare enim cor	nostrum intelli	0
ris dedicatione	agetur: quod es	0
altare in medio	ecclesiae: de a	0
levitico. Ignis	in altari meo s	0
 charitas. alta	re est cor mund	1
in altari: quia	charitas semper	0
o. Unde salomon	in canticis can	0
on potuerunt ex	tinguem charita	1
ngui non potest	vos ergo secund	0
e in confrequen	tationibus seu 	1
ltaris: quia re	liquiae cogitat	1
ibi. De hac apo	stolus excellen	1
 ipsa est super	omnes virtutes 	0
erram quod adeo	breve est: ut d	0
ac quicquid vis	ex his namque d	0
 pendet et pro-	phete. Vel per 	1
nimam intelliga	mus: quae edifi	1
vis scilicet ex	virtutibus vari	0
o limteamina al	ba quibus operi	1
umilitatem sal-	vatoris designa	1
andidantur: si-	cut et christi 	1
s enim grece di	citur palus; et	1
 etiam dixerunt	quod homo non p	0
udis pedibus am	bulet. Contra q	1
lus. Cor. x. Om	nia mihi licent	1
nt. Exquo datur	intelligi quod 	0
 assumantur tam	quam expedienti	1
opposita reddun	tur illicita. O	1
qui dicunt econ	trario opera pe	1
a communi vitae	fidelium. Sicut	0
initas non prae	fertur coniugio	1
itur. Cor. viii	Qui matrimonio 	0
e facit. et qui	non iungit meli	0
us. qui equavit	statum divitias	0
upertatis prop-	ter cristum ass	1
. xviii. Si vis	perfectus esse 	0
arbitrium sicut	negaverunt quae	0
i sunt male cre	ationis non pos	1
uos dicitur pri	ma. Io. ii. Hae	1
ccetis. Decimus	error est praes	0
anicheorum dice	ncium homines e	1
igatos. Ita sci	licet quod eoru	1
astrorum subiec	ta. Contra quos	1
 signis celi no	lite timere qua	1
imus est error.	dicentium quod 	0
itatem habentes	peccare non pos	0
t eos quae ali-	quando peccant 	1
se. Contra quos	dicitur. Aposto	0
inam reliquisti	memor esto unde	0
 peccasset sive	non Consilium d	0
tiam nobis can-	tica canticorum	1
tiat: et de fi-	lio dei ad glor	1
 quid affirmat.	Ecce iste scili	0
liens in monti-	bus et transien	1
super omnes san	ctos et angelor	1
: stat post pa-	rietem nostrum 	1
m est prospici-	ens per fenestr	1
r cancellos sen	suum scilicet i	1
icet dei filius	loquitur mihi s	0
bum fieret caro	dicens surge am	0
 mulieres. Veni	columba mea: in	0
ormosa mea: iam	hiems transit a	0
am dei in genus	humanum erga il	0
ali hyeme posse	capi. ideo imme	0
t recessit flo-	res apparuerunt	1
et Maria et nul	la macula est i	1
it omnes colles	omnes sanctos e	0
uit maiori lau-	de gloriaque di	1
mptor christus:	quam destructor	0
peccati: qui fu	it de terra vir	1
deturpata Quomo	do ergo christu	1
 esse deterior.	quantum ad huiu	0
am Nam ut etiam	asserit aureliu	0
xxxxiii. dicens	Sicut in caelo 	0
eternum. sic et	in terra habuit	0
arentem. Erube-	scant hi et amp	1
e dicitur. Sur-	ge amica mea sp	1
cula est in te.	Amplius nonne f	0
o. ut verbum ac	unigenitum fili	0
i caro nobilio-	ris maiorisque 	1
d originem ipso	Adam. ¶ Nonne f	0
enito filio dei	cum amore spiri	0
i ergo non fuit	omnipotentiae d	0
or canaquil am-	mirata/ servatu	1
vit: et ad regi	um fastigium ev	1
is eventus illa	flamma/ quae ex	0
exercituum quos	interitus publi	0
ispania debili-	taverat capite 	1
mque eius aspec	tu pavidi adhuc	1
re fortitudinem	amoniti. octo e	0
um cesis: magno	que numero in p	1
 castra punicis	opibus referta 	0
m bello acri et	diutino vehient	0
 compulsi: capi	non possent: ea	0
sidentibus quam	obsessis intole	0
toriae iter mi-	ro prodigio dii	1
Subito enim al-	banus lacus neq	1
s. neque in un-	datione ullius 	1
stagni modum ex	cessit. Cuius r	1
d delphicum ora	culum missit re	1
quam eius lacus	emissam per agr	0
ehios in potes-	tatem populi ro	1
riusquam legati	renuntiarent. a	0
ite nostro quia	domestici inter	0
castra perlatus	futurum dixerat	0
edictione moni-	tus eodem pene 	1
vit. et hostium	vrbe potitus es	0
 successus quod	sequitur. L. si	0
 in agro nolano	ante praetorium	0
arte are prolap	sam. anguem pro	1
tumii aruspicis	hortatu continu	0
 eduxit. ac for	tissima castra 	1
ia futurae eius	amplissimae pot	0
mentum extitit.	¶ Idem silla cu	0
tra marium cas-	tra movisset: a	1
todiri se postu	mius aruspex vo	1
LIBER	qui locus quiet	0
 plenissimus vi	debatur: in eo 	1
stiarum: et tur	bulentissimae t	1
unt. Neque vero	nobis cupientib	0
us fructus ocii	datus est: ad e	0
s dediti fuimus	celebrandas. in	0
ndas. Nam prima	aetate incidimu	0
tionem discipli	nae veteris et 	1
us in medium re	rum omnium cert	1
men: et hoc tem	pus omne post c	1
imus iis flucti	bus: qui per no	1
ulsi. in nosmet	ipsos redundare	0
l asperitatibus	rerum: vel angu	0
 inimicorum vel	causae amicorum	0
cii: ad scriben	dum potissimum 	1
ro frater neque	hortanti deero:	0
neque auctorita	te quisquam apu	1
e potest: neque	voluntate. Ac m	0
eteris cuiusdam	memoriae: non f	0
recordatio. sed	ut arbitror apt	0
s: ut cognoscas	quae viri omniu	0
arissimique sen	serint de omni 	1
is enim ut mihi	saepe dixisti: 	0
aut adolescenti	bus nobis: aut 	1
stris: inchoata	atque rudia exc	0
e digna: et hoc	usu quem ex cau	0
isque consecuti	sumus: aliquid 	0
s a nobis perse	Qui locus. temp	0
nquillitas vero	animi. Tempesta	0
parationes sunt	inter tempestat	0
rimo aenei. hic	comparat sediti	0
 Cupientibus et	optantibus. plu	0
eramus consequi	posse. Cupimus 	0
 aetate incidi-	mus in perturba	1
seditiones quae	fuerunt inter S	0
eteris discipli	nae: perturbati	1
it. Dicit enim.	Romanos a consu	0
maiorum declina	re coepisse. A 	1
principio consu	latus nostri. C	1
tentionum: quia	simul ac creatu	0
ero: in conten-	tionem adduxit 	1
Et discrime. po	test esse hoc s	1
eo bene iunxit.	Iis fluctibus. 	0
nslatione: quam	superius fecit.	0
P. Clodii facti	ones intelligit	1
post consulatum	suum maximo per	0
pertus est. Nam	ne bonos cives 	0
itio (ut an di-	ximus) obiicere	1
 tamen quamquam	haec omnia me a	0
hant. Sic plane	videmus quomodo	0
olentiam captat	a persona sui. 	0
nes tempestates	nequaquam possu	0
here a studiis:	quin fratris ob	0
ntum discrimina	tam publica qua	0
gustiis. ad dis	ciplinas malas 	1
ero frater. hic	benivoleotiam c	0
 auditoris. Di-	dicimus enim ab	1
a benivolentiam	capi. si profer	0
s estimatio sit	Nam ostendit qu	0
 fratre aestima	tio: cum dicat 	1
ctoritate magis	persuadendo: ne	0
te potius rogan	do eum posse mo	1
ro. ac si dicat	et si caeteris 	0
ecto non deero.	Alium neque auc	0
tetur. Neque vo	luntate: si rog	1
auctoritate. Ro	ganti. voluntat	1
i. comparat at-	tentionem. Faci	1
itorem attentum	a rebus ipsis: 	0
se de rebus ma-	gis esse dictur	1
s rebus quae ad	ipsum auditorem	0
t. Non satis ex	planata. non sa	1
r ipsos disputa	tores qui ad ip	1
tationem conve-	nerant. Nam pro	1
 homines cum de	re magna per di	0
ere sententiam:	quo fit ut non 	0
plicari quaeat.	Crassum enim Co	0
icendi. et unus	quisque suam se	0
 adolescentibus	si non puer. sa	0
cendi genere ru	dia quidem: qui	1
erem intelligit	quam constat in	0
oatum reliquit.	Nam cum sint qu	0
on probavit. At	que rudia. prae	1
s usus est Cice	ro: ergo inchoa	1
bus: quibus ma-	xime viget eloq	1
igniora scribe-	re poterat. Usu	1
it causas. Tan-	tis. ad dignita	1
ta: ad superio-	ra ergo ista. D	1
bet climate du-	as in se contin	1
radus ascendens	qualibet hora a	0
ationes domorum	celi comprehend	0
scendentis: tem	pus a meridiae 	1
n secunda locus	solis verus sit	0
signi et gradus	ascendens appre	0
quentibus prae-	dicta continuan	1
reviter expone-	mus. Scito enim	1
 e directo ver-	sus partem dext	1
 alios autem ho	ras atque minut	1
dem gradu solis	prius quaesito 	0
 sub titulo tem	pus a meridiae 	1
stans hora vide	licet ad horas:	1
nutorum numerus	sexagenarius ex	0
um in horis pro	positis adiunga	1
imumquartum nu-	merum: numerus 	1
s numerus in ho	ris atque minut	1
idiae quaeratur	quo invento:e d	0
itulo ascendens	signum et gradu	0
 faciliter edu-	centur: quae al	1
us exemplum. Si	in sexto climat	0
iem scire desi-	deras. sole in 	1
ula ascendentis	sexti climatis 	0
artem sinistram	sub titulo temp	0
inutis reperies	quibus: tempus 	0
uor in minutis:	minuta minutis:	0
minutorum nume-	rus sexagenariu	1
 propositis ad-	iungatur. Sic e	1
rus horarum ex-	cedit. quibus a	1
unt. quae in ta	bula ascendenti	1
in minutis: sub	titulo tempus a	0
pinquiorem unum	scilicet in hor	0
exteram sub ti-	tulo ascendens 	1
oris propositi.	Sic suo modo al	0
ns occurret pro	quolibet tempor	0
t subtractionem	remanet: in tab	0
supra invenies.	Poteris tamen t	0
gradu solis in-	ventum: semper 	1
terius diei per	vigintiquatuor 	0
te meridiem cum	gradu solis tem	0
praecedentis ad	horam octavam p	0
e) in faciendis	consulere Incau	0
quid vel consen	tire vel dissua	1
rali suscipien-	da (amantissima	1
m expertum tuis	me litteris pia	0
ique difficilem	requiris. Inter	0
ori nullus ple-	bano officio vi	1
fixus est nobis	omnibus scienti	0
tidiae crucifi-	gitur (eodem ch	1
ec servus super	dominum suum. S	0
 Xpristus in vi	ta eterna ad de	1
brium patienter	sustinens. Pleb	0
 christum locum	tenet tribulati	0
 solum in eter-	na gloria post 	1
t officium immo	in iudicando vi	0
o sedebit iudex	praecipuus. Qui	0
nis eius verbum	Unde petro de l	0
istus ait. Amen	amem dico vobis	0
bitis super se-	des iudicantes 	1
storis ita glo-	riam eiusdem et	1
 in hac re tibi	et consentio/ e	0
d consentiendum	meritum inducit	0
Ego pastorum in	dignissimus inf	0
 nondum est fi-	nis. Si ad chri	1
 ad conscriben-	dum tua oppria 	1
go aliquas tibi	temptationes pr	0
endum sit in te	dimittere. Quis	0
rtat/ novem dia	bolos sine inte	1
od nequaquam su	stinuisset serv	1
llerat dominus.	Primus diabolus	0
 diabolus inter	omnes est ipse 	0
 non remanet de	non nisi.n. Sed	0
o loco componi-	tur ex non et u	1
. Nusquam ange-	los apprehendit	1
uam pertinet ad	tempus. nusquam	0
e quida. Ad tem	pus numquam sed	1
usquam. Simili-	ter unquam part	1
locum.	Nuper adver. te	0
hoc tempus.	Nuspiam. adver.	0
oco. et dicitur	a non et uspiam	0
 non et uspiam.	Nusquam. vide i	0
ide in numquam.	Nutatim. adver.	0
tur. vel de nu-	tu in nutum. qu	1
itur per nutus.	Nutanter id dub	0
t. Nam interdum	interiectio est	0
s in quanta mi-	seria. Interdum	1
. ut O rem admi	rabilem. Interd	1
s adverbium. ut	O mihi praesent	0
tus anni. Exhor	tantis quorum. 	1
 indignatur ad-	optat. Clamat c	1
 velut exemplis	reperitur. Vel 	0
clamat. vocitat	miratur. et opt	0
nominat ut pro-	hibetur.    1
ris sequentibus	mutat. b. in il	0
ido. f. ut Offe	ro. g. ut Oggan	1
pono. Quandoque	subtrahitur b. 	0
tem sequatur m.	subtrahitur b. 	0
 mutatur in. m.	ut Ommitto. Qua	0
cipit s. cum di	ctione incipien	1
curus. Unde qui	dam. Cur fert g	1
nunc ob mutatur	in illas.   0
in illas.	Obnixe id inten	0
o palam locutus	sum mundo. Et c	0
et der impalam.	et in aperto. P	0
sitio quando re	git casum. ut P	1
est coram illo.	Et cor. primam.	0
m prod. Unde Lu	canus in. vij. 	1
cere palam civi	lia bella. Sed 	1
ba quaeritur an	debeat acui. Et	0
od sic. ad dif-	ferentiam huius	1
la. lae. palam.	Alii dicunt quo	0
ia habemi adver	bia in am desin	1
in fine. ut mul	tifariam. perpe	1
riam. perperam.	Palenter id man	0
agantur. Vel pa	lanter id incom	1
rs. qualitatis.	Pape interiecti	0
is. Unde. Cedit	papa papae. non	0
t munera papae.	Accipe tolle ca	0
lacentia papae.	Palin id iterum	0
. vel apud. vel	re. vel praesen	0
ter. vel trans.	Partim. adver i	0
m per. ut Parum	per id valde pa	0
tiam parunante.	sed potius sunt	0
im. vel lenitur	Paulatium. adve	0
ulatis. pedeten	tim. minuatim.  1
tim. minuatim.	Pauliser id par	0
um vel modicum.	Paulominus. qua	0
 id i. fere. ut	ibi. Paulominus	0
unt me in terra	Quandoque est o	0
ones. ut ibi Mi	nuisti eum paul	1
dicitur. Si pau	lominus est ora	1
t inde. Esto fe	re si dictio si	1
 una. Item nota	quod paulo non 	0
ine in paulo mi	nus quoniam sun	1
tem paulo prius	due partes sunt	0
omponitur paulo	M 3 1
sunt regis impe	rio. et quia vi	1
rant. quod sibi	bene vivendo ac	0
em convereteret	Sed et daniel c	0
eonum rabiem in	ovium mansuetud	0
rociam eorum fi	de fregit. Nequ	1
culpes. nec col	laudes senem. N	1
tatis virtus ac	malicia congnos	0
is. Quod si fue	ris sobrius. ni	1
ra nocebit etas	Et si fueris ne	0
i prodesse. non	potest. Canicie	0
capilli candidi	requiruntur Ist	0
. matuere virtu	tis possidebat 	1
o sciens samuel	ad yesse consti	0
tudine vallatus	militum nec amb	0
niens sed cornu	quo erat sanctu	0
 et dicit ei mi	sit me dominus 	1
s constituam re	gem. estimans i	1
tam filio digni	tate adducit eu	1
ui dicit samuel	Transeat. non e	0
nit et secundus	nec ipem placui	0
s et quartus et	quintus et reli	0
lebatur numerus	filiorum. et qu	0
niebatur in nu-	mero filiorum. 	1
. Numquid defe-	cerunt filii. E	1
o. inquit. unum	filium parvulum	0
pascit oves. Tu	autem regem req	0
iuri ope-	ram datum prius	1
tum prius nosse	oportet unde no	0
rtet unde nomen	iuris descendat	0
scendat. ff. de	iusti. et iure.	0
 l. i. in prin.	Etiam ut ait ph	0
icorum. qui vir	tutes vocabulor	1
de facili para-	logisantur. id 	1
Nisi enim nomen	rei scieris cog	0
ecundum Isidem.	Turpe etiam vid	0
 nobili viro et	causas perorant	0
r ignorare. ff.	de ori. iur. l.	0
ores. quod. nam	cum dixissem. e	0
um ex iniuncto.	xxxviii. dis. s	0
bus omnibus ha-	betur quod nemo	1
cientiam in qua	versatur. Quod 	0
egislator vulpi	anus dicit: Ben	1
verborum inter-	praetationem pe	1
ipsius signifi-	tatione tituli 	1
pe. l. i. Idcir	co quorundam te	1
in iure utroque	maxime frequent	0
arium fore duxi	descriptiones e	0
nes clarius ex-	ponere tam in s	1
os. quam aliun-	de collectorum 	1
es maxime iurum	utriusque alumn	0
brevi alphabeti	ordine ut eo me	0
commendentur et	tanto citius in	0
ringendo: etiam	cum allegantion	0
uis. ut in iure	modicum perfect	0
minime proceden	tes. his cognit	1
 terminorum si-	gnificationibus	1
iliorem habeant	ad utriusque iu	0
a omnium habere	memoriam et in 	0
 errare: potius	est divinitatis	0
is. C. de vete.	iur. enu. l. ii	0
d. quia omnium.	Et nont Bernare	0
m adeo. in glo.	j. de confir. u	0
rrecta. in glo.	ii. Et si lecto	0
ula occurrerint	quorum expositi	0
atur de hoc non	miretur. quia n	0
moria potuit oc	currere. Et pri	1
Quando fa-	cit separatione	1
ndo includit et	quando excludit	0
Io. an. de prae	bem. c. statutu	1
lec. ca. i. eo.	li. Et a et ab 	0
xi. di. aliter.	Et de a in. c. 	0
et contu. Etiam	a et ab denotan	0
m. C. de nupti.	l. a caligato. 	0
. iii. l. ordi-	dinata. ff. de 	1
 ex duobus. ubi	tex. cum glo. f	0
. §. fi. Item a	vel ab est dict	0
a primi termini	a quo. sicut di	0
m ad quem. Hunc	ant temporum a 	0
sive vel inclu-	sive. de quo Ba	1
s. ff. de lega.	iii. unde a vel	0
 exclusive. di-	cendo in statut	1
ampanae de sero	nullus vadat pe	0
a tali. Nam hoc	statutum intell	0
ampana. Ideo si	quis vadat quan	0
t in penam: in-	clusive. signic	1
 canpane. de ma	ne quisque pote	1
statuens sic vi	detur intellexi	1
lenius de istis	dictionibus per	0
in sua practica	in forma capitu	0
 producuntur ad	eternam rei mem	0
m rei memoriam.	¶ Abavus est pa	0
vie. sicut pro-	auus est pater 	1
r avi vel avie.	¶ Abavia est ma	0
oavie. sic pro-	avia est mater 	1
ysidic. ix. li.	ethimo. et plen	0
l. iurisconsul.	.§. quarto grad	0
. tertio gradu.	¶ Abauunculus e	0
ecundum Isidem.	Abamita est sor	0
ie. De his ter-	minis vide inst	1
. tertio gradu.	¶ Abnepos est f	0
ut nepos filius	filii vel filia	0
li. ix. ethimo.	¶ Abneptis est 	0
el neptis sicut	neptus filii ve	1
 Isi. ubi supra	¶ Abigere est a	0
l crimem abigea	tus exercere ut	1
re ut sequitur.	¶ Abactor secun	0
est fur iumento	rum vel pecudum	1
vocamus abigeum	Nam abigeus est	0
s committit. et	proprie ille qu	0
 pascuis et ar-	mentis subducit	1
studio. et hanc	artem exercens 	0
gnum quod facit	ipsa animalia f	0
et dispergantur	et ea sic recip	0
panno rubeo vel	alios oves quas	0
mora fugando ut	alius accipiat 	0
t est abigeatus	crimem capitale	0
s. l. unica. Et	maximus orator 	0
recos demosthe-	nes differentia	1
 Genesis	ad noe in archa	0
 sunt. masculus	et femina ex om	0
cut praeceperat	ei deus: et inc	0
i Factumque est	diluvium quadra	0
m. et multipli-	cate sunt aquae	1
am in sublime a	terra. vehement	0
 et omnia reple	verunt in super	1
archa ferebatur	super aquas: et	0
s super terram.	opertique sunt 	0
b universo celo	Quindecim cubit	0
per montes quos	operverat. Cons	0
s caro quae mo-	vebatur super t	1
mantium bestiam	omniumque repti	0
erram. Universi	homines et cunc	0
e est in terra.	mortua sunt. Et	0
ubstantiam quae	erat super terr	0
pecus. tam rep-	tile quod voluc	1
nt de terra. Re	mansit autem so	1
 erant in archa	Optinueretque a	0
uinquaginta die	bus.    1
minus none cunc	torumque animan	1
tium. et omnium	iumentorum quae	0
erant cum eo in	archa. adduxit 	0
ritum super ter	ram: et inminut	1
lausi sunt fon-	tes adyssi et c	1
hibite sunt plu	viae de caelo. 	1
a. euntes et re	deuntes: et coe	1
quinquaginta di	es. Requievitqu	1
eptimo vicesimo	septimo die men	0
es armeniae. At	vero aquae iban	0
sque ad decimum	mensem. Decimo 	0
rima die mensis	apparueret cacu	0
 Cumque transis	sent quadragint	1
fenestram arche	quam fecerat di	0
diebatur et non	revertebatur do	0
e super terram.	Emisit quorum c	0
 videret si iam	cessassent aqua	0
ae cum non inve	nisset ubi requ	1
a est ad eum in	archam. Aquae e	0
m terram. Exten	ditque manum su	1
tulit in archam	Expectatis aute	0
liis: rursum di	misit columbam 	1
la venit ad eum	ad vesperam: po	0
rentibus foliis	in ore suo. Int	0
essassent aquae	super terram. E	0
ilominus septem	alios dies. et 	0
non est reversa	ultra ad eum. I	0
 arche aspexit.	viditque quod e	0
ies terrae. Men	se secundo sept	1
e mensis arefac	ta est terra. L	1
 ad noe dicens.	Egredere de arc	0
a filii tui. et	uxores filiorum	0
 animantia quae	sunt apud te ex	0
olatilibus quam	in bestiis. et 	0
ptant super ter	ram. educ tecum	1
 terram. Cresci	te et multiplic	1
est ergo noe et	filii eius. et 	0
um eius cum eo:	sed et omnia an	0
quae reptant su	per terram. sec	1
a sunt de archa	Edificavit aute	0
tollens de cunc	tis pecoribus e	1
. obtulit holo-	causta super al	1
inus odorem sua	vitatis: et ait	0
aledicam terrae	propter homines	0
ione humani con	dis in malum pr	1
centia sua. Non	igitur ultra pe	0
ut feci cunctis	diebus. terrae 	0
us et estus. e-	stas et hiemps.	1
on requiescent.	¶ Capitulum ix.	0
¶ Capitulum ix.	Enedixitque deu	0
filiis eius. et	dixit ad eos. C	0
e et multiplica	mini et replete	1
m. et terror ve	ster ac tremor 	1
er cuncta anima	lia terrae et s	1
es celi cum uni	versis quae mov	1
erram. Omnes pi	sces maris: man	1
i sunt. et omne	quod movetur et	0
s in cibum. Qua	si olera virent	1
 omnia: excepto	quod carnem cum	0
ommedetur. Sang	uinem enim anim	1
requiram de ma-	nu cunctarum be	1
 hominis. De ma	nu viri et de m	1
am omnem animam	hominis. Quicum	0
anum sanguinem.	fundetur fangui	0
inem dei quippe	factus est homo	0
 et multiplica-	mini. et ingred	1
 et implete eam	Haec quorum dix	0
ios eius cum eo	Ecce ego statua	0
scum. et cum se	mine vero post 	1
ventem quae est	vobiscum. tam i	0
iumentis et pe-	cudibus terrae.	1
a sunt de archa	et universis be	0
onsilioset manu	mittentis et ip	0
o quod bona non	sunt suffectura	0
a creditoribus.	¶ Eadem lege el	0
entia domino mi	noris annis. xx	1
non aliter manu	mittere permitt	0
a cam manumissi	onis approbata 	1
ata fuerit manu	missi. ¶ Iustes	0
ant manumissio-	nis case hae su	1
uti si quis pa-	tremq autem mun	1
t nutricem: aut	educatorem: aut	0
alumnumsem alum	namve: aut coll	1
ectaneumse manu	mittat: aut sec	0
um procuratoris	habendi gratia:	0
ttitur procura-	torum habendi g	1
a. xvii.set an.	manumittatur. ¶	0
autem causam ap	probataª: sive 	1
a sivesem falsa	sit. non retrac	0
manumittendi mi	noribus. xx. an	1
it eveniebat ut	qui quatuordeci	0
m annos expleve	rat: licet test	1
ossit: et in eo	sibi haeredem i	0
ituere: legata-	m ¶ Minori. suf	1
x. an. etiam si	non sit maior: 	0
uper hoc delibe	ratio. et sic p	1
 et sic ponitur	id quod fit. pr	0
uod fit. pro eo	ubi fit. ut. ff	0
uris. l. pe. §.	fi. Vel dic apu	0
i. Vel dic apud	eos qui praesun	0
os qui praesunt	concilio. ut su	0
. ut sunt omnes	habentes ordina	0
habentes ordina	riam iurisdicti	1
iurisdictionem.	etiam minimi ma	0
etiam minimi ma	gistratus. cum 	1
tratus. cum hoc	sit de voluntar	0
t de voluntaria	iurisdictione. 	0
isdictione. ut.	ff. de offi. pr	0
e offi. procon.	et. le. l. ii.  0
bere servum su-	um patrem. vel  1
um patrem. vel	econtra. vel fr	0
ontra. vel fra-	ter fratrem suu	1
r fratrem suum.	sive sororem. R	0
ororem. Respon.	bene. ut quia i	0
ne. ut quia in-	stituit dominus	1
 dominus filium	servi sui haere	0
vi sui haeredem	vel filium anci	0
 filium ancille	vel econtra. et	0
econtra. et sic	de aliis. quo c	0
 aliis. quo ca-	su fit institut	1
 institutus hae	res liber et do	1
iber et dominus	omnium bonorum 	0
ium bonorum quo	rum dominus fui	1
ominus fuit te-	stator. ut. sup	1
t. supra. e. §.	j. et. ff. de a	0
 haeredes. Item	potesse. ut hab	0
otesse. ut habe	at. quis filium	1
 quis filium ex	ancilla sua. na	0
ncilla sua. nam	est servus et f	0
ervus et filius	ut. C. conia de	0
C. conia de ma.	l. fi. et econt	0
 et econtra. si	servus habeat f	0
ervus habeat fi	lium ex domina.	1
 ex domina. nam	filius est et l	0
us est et liber	et dominus cum 	0
dominus cum ven	trem sequatur q	1
ven. l. partum.	licet possit ip	0
uae servis pro-	pri. l. j. et. 	1
i. §. i. Accur.	s ¶ Pedagogum s	0
s. a pedos quod	est puer et gog	0
atur ductor si-	ve gubernator p	1
nator puerorum.	t ¶ Alumnum. pa	0
it. ut differat	a superiori. Ac	0
periori. Accur.	v ¶ Collectaneu	0
t. quem fratrem	bonus. appellan	0
nus. appellant.	x ¶ Ducatur. pr	0
 ut. ff. de ma.	vin. si collect	0
ctaneus. in fi.	i ¶ Iusta causa	0
dilationem. ut.	n. si quis. cau	0
situm. vel alia	qualibet iusta.	0
. ca. ma. l. i.	z ¶ Decem et se	0
minor. xxv. an.	potest esse pro	0
. ff. de procu-	si minor. Respo	1
ic et alios est	differentia int	0
manda. si procu	ratorem. §. i. 	1
. i. Accursius.	a ¶ Semel. appr	0
. ff. de excep.	rei iu. l. qui 	0
lsa id iniusta.	ut quia dixi eu	0
vel in scholis.	quod inducebam 	0
 vel simili ap-	probata. licet 	1
ontra iusta pro	vera. ut. supra	0
in prin. Accur.	que relinquere 	0
 tamen si adhuc	minor sit vigin	0
ti annis liber-	tatem servo dar	1
n poterat. quod	non erat ferend	0
 si is cui toto	rum suorum bonu	1
stim dispositio	data erat: uni 	0
rvo dare liber-	tatem non permi	1
re non similter	ei quaemadmodum	0
ios res: ita et	servos suos in 	0
ltima voluntate	disponere: quem	0
emadmodum volu-	erit permittimu	1
. ut libertatem	eis possit prae	0
d est cum liber	tas inextimabil	1
es sit: et pro-	pter hoc ante v	1
icesimum etatis	annum antiquita	0
 libertatem ser	vo dare prohibe	1
t: ideo nos me-	diam et quodamm	1
viam eligentes:	non aliter mino	0
i viginti annis	libertatem in t	0
stim dare servo	suo concedimus:	0
si. xvii. annum	impleveritur: e	0
i. annum attige	rit: ¶ Cum eius	1
 huiuset etatus	et pro aliis po	0
es concesserit:	cur non etiam s	0
udicii stabili-	tas ita eos adi	1
iuvare credatur	ut et ad libert	0
ates dandas ser	vis suis possin	1
sint pervenire.	¶ De lege suffi	0
e suffia canina	tollenda. Rubri	0
lenda. Rubrica.	c ¶ Retractetur	0
 ex sollemnibus	ut. ff. de in i	0
 tu. l. sed re-	probari. i. Res	1
avore sanitatis	d ¶ Cum ergo co	0
xii. ut. ff. de	testa. qua. eta	0
qua. etate. et.	ff. de liber. l	0
iber. le. aure-	lio. §. caius.  1
lio. §. caius.	f ¶ Sed cum lib	0
¶ Sed cum liber	tas. usquehuc a	1
squehuc allegan	do innuit quod 	1
nuit quod eodem	tempore possit 	0
 possit manumit	tere quo testar	1
o testari. nunc	econtra duas ra	0
ntra duas ratio	nes considerans	1
considerans. et	quia in extimab	0
 in extimabilis	est libertas. c	0
ibertas. cum si	vendat quis se.	0
t quis se. prae	cium ad vendito	1
ium ad vendito-	rem non transit	1
on transit immo	penes emptorem 	0
e dominum rema-	net. unde est i	1
s. l. libertas.	et quia antiqui	0
rviendum ut. C.	de testa. l. te	0
ibus solvit. me	diam eligens vi	1
 sit ar. contra	ff. de neg. ges	0
 Accur. floren.	h ¶ Impleverit.	0
nt. et liberta-	tes relinquere 	1
olla. ix. §. i.	quod exaudio. s	0
s libertatem re	linquere. quod 	1
in dicto autem.	positum est. qu	0
f. de ta. exhi.	l. j. §. fi. Se	0
ittere. Respon.	non potest. nis	0
ognita. cum nec	liber iste. nec	0
tate. unde ser-	vatur tenor eiu	1
 sit correctus.	ut. C. de appel	0
ntuli sui coram	iudicibus expon	0
autem pro se po	terit esse in i	1
est ratio. quia	quando pro alio	0
ommittit causam	suam. ut. ff. d	0
l. cum mandato.	l ¶ Pervenire. 	0
s non est ratio	quare sit diver	0
est. ut. ff. de	ver. obliga. l.	0
 a titio in fi.	¶ De lege suffi	0
Fetus.	Fetura. 0
Finis.	Compendiosus de	0
ctandi dialogus	feliciter incip	0
liciter incipit	Iscipulus. Salv	0
 magister egre-	giae Magister. 	1
tu charissime a	dolescens. D. N	1
d olim audivi a	te doctissimae 	0
ctandi rationem	nedum legenti: 	0
simul et audito	ri / non pervum	1
. Sic est. con-	sentanea etenim	1
licentis pertes	seperant. pronu	0
bus quam oratio	nis sensus dist	1
nstrant. D. Dic	igitur quaeso m	0
tus. M. Iam fe-	re dictum puto.	1
el figura / vel	mora sua / clau	0
 distinguit. a-	nimum recreat. 	1
linquit. Et fit	aut mora pronun	0
aut impressione	calami. quorum 	0
formandi. D. Cu	ius at cum impr	1
urae est. M. Mo	do unius: modo 	1
rout aggregatio	vocum recte pos	0
odis prope qui-	dem formari pot	1
imus esse gene-	ra punctorum li	1
 periodum / pum	ctumque interro	1
rgo definias et	singula ubi loc	0
M. perlibentur.	Nam vergula / e	0
/ dexteram ver-	sus parte erect	1
 post dictiones	verbo ac perfec	0
claris virum vi	ris ludi subdis	1
punctus cum vir	gula superius e	1
me virgule sic:	et locatur cong	0
nes virbum: sed	perfectionis ex	0
 distinctio est	Colon / est sol	0
ecundum impers-	sionem calami s	1
te ponatur post	dictiones debit	0
fectionem haben	tes: signat tam	1
iam non imperti	nens iungi poss	1
m nomen clausu-	le sortita est.	1
ctus planus cum	virgula curva i	0
orsum ducta sic	Punctus interro	0
 punctus planus	cum virgula ret	0
recte post ora-	tionem interrog	1
ne ea quae dixi	Et haec sunt ge	0
uibus clausulas	distinguere deb	0
 vero / quae ab	incepta clausul	0
ecta clauditur:	duobus semicirc	0
ique eam ut hic	vides: notare s	0
rcludere. D. vi	deo. M. Sunt ta	1
 / quae clausu-	las non respici	1
um est / ad in-	cognitum sive n	1
rsonae signifi-	candum. aut eti	1
tis. Cui puncto	nomem / ut quib	0
unctus est. Bis	etenim per tran	0
Alterum / semi-	punctu nominant	1
t per transver-	sum ad dextram 	1
n fine alicuius	lineae dictio s	0
x linea suscipi	ens complementu	1
diceres / ut de	his quorum exem	0
tem pervum nunc	poneres. M. Dec	0
c sit exemplum.	Cum neglecta de	0
s constructione	recta punctandi	0
ssit: debet hu-	ius artis cupid	1
icae praeceptus	operam dare. In	0
s dictionibus /	perfecta racion	0
iter si placet:	quo pacto punct	0
 ostendunt viam	pronuntiandi. M	0
 mora temporis.	Virgula enim / 	0
: parvam tempo-	ris moram exigi	1
usculam: cum su	spensa tamen vo	1
Periodus / pro-	lixius interval	1
 de ratione pun	ctandi / si ad 	1
mmodaveris / ti	bi sufficient. 	1
 velis. D. quam	gratissimo. Sem	0
ssimae magistru	M. et tu amanti	0
mae adolescens.	Finis.  0
Finis.	Incipit tractat	0
entu perutilis.	Ccentus est art	0
ciosa modulatio	vocem in signif	0
prolatione Tres	siquidem sunt p	0
 scilicet melli	ca. quae attend	1
tu. et illi ad-	iacet neuma. qu	1
quae attenditur	in scansione me	0
et tempus. Sig-	nificativa sive	1
itur in communi	sermone. et ill	0
Sunt autem tres	accentus princi	0
i sit per eleva	tionem vocis. u	1
nominis dominus	et representatu	0
b oxi. quod est	acutum. Gravis 	0
nationem vocis.	ut patet in med	0
ne Deus qui sa-	lutis. ¶ Sed qu	1
m dominicam eve	nerit: tunc pra	1
m septimana in-	fra octavam aep	1
tur et tunc di-	cetur pars sequ	1
 Et post primum	diem epiphaniae	0
llecta de festo	epiphaniae omit	0
iae omittuntur.	De dominicis in	0
s infra octavam	epiphaniae et s	0
 septuagesimam.	¶ In singulis d	0
e usque ad sep-	tuagesimam sive	1
anctis dicetur.	Suffragium de b	0
usque ad festum	purificationis 	0
tio cottidiana:	et Ite missa: d	0
do Festum Timo-	thei suae conve	1
tarum dominica-	rum evenerit: t	1
s. Quando autem	aliqua festa sa	0
rvantur: praedi	ctis dominicis 	1
calia eodem tem	pore occurrenti	1
nctis dominicis	diebus eveniunt	0
s servantur. In	quibus dominica	0
 Credo pro tunc	feriatis diebus	0
o cottidiana et	Ite missa est. 	0
iphaniae et Sep	tuagesimam occu	1
 dominicalia ha	bentur sicut se	1
ones sanctorum:	etiamsi feriale	0
iis officiis ca	rentibus eveniu	1
 cogente surro-	gentur et serva	1
 nullae commemo	rationes sancti	1
unt. tunc quoti	enscumque aliqu	1
officium non ha	buerit repetend	1
rate. per totum	cum propriis co	0
ibet dominicae.	Et quando aliqu	0
ngelium non ha-	buerit: tunc di	1
u in naviculam.	Vel secundum al	0
omini qui semi-	nat semen bonum	1
m Epiphaniae et	septuagesimam p	0
¶ Capitulo I	Folio U 0	
Folio U	inquit pater me	0
oribus reliquit	obnoxium: quibu	0
cottidiae labo-	ro. sed uni eor	1
satisfacere non	queo: castrimar	0
plorans incita-	menta. Constat 	1
 multa sunt de-	lictorum tribut	1
nima obnoxia ni	si rursus dei a	1
rata: pristinam	non valet recip	0
tatem. Hinc mi-	sericors dominu	1
stris ad iracun	diam permotus: 	1
animam hortatur	dicens. Plange 	0
go accincta sac	co super virum 	1
ae. Super virum	pubertatis suae	0
asi vergo plan-	gitur quoniam p	1
tatis amore per	fusa sui conubi	1
considerans con	funditur. Ideo 	1
ta cilicino sua	facta deflere i	0
tinus penitendo	ne a domino iud	0
cilicet peccato	res prius corri	0
nde super virum	pubertatis suae	0
is opera perfi-	ciat adhortatur	1
ans ploravit in	nocte et lacrim	0
lacrime eius in	maxillis eius.  0
maxillis eius.	Quae nam sit qu	0
ittera ex prin-	cipio versus in	1
us interpretari	ostenditur. Bet	0
s interpretatur	Scilicet illa c	0
gressus in aegy	ptum: et postea	1
fragante clemen	tia mira: exige	1
ulpis rursus ad	captivitatem in	0
ucitur: et ideo	amarissimae plo	0
hibetur. Plorat	autem in nocte:	0
e nulla dabatur	eis requies: sa	0
uis consolaren-	tur lacrimis: e	1
 sero abluerent	quos ad idola p	0
male levaverant	et quod gravius	0
amicis sibi pes	sime blandienti	1
a teste: nullus	eam consolabatu	0
planguntur ini-	mici. Lacrime i	1
n maxillis eius	ut maiori induc	0
usione inter ho	stes et suis sa	1
opprobriis. Pa-	tet igitur sens	1
olatriam patris	in captivitatem	0
yloniae: plenus	scelerum suorum	0
nia. dure satis	ab hostibus tra	0
 Sed durior ac-	cidit ea captiv	1
 tito et vespa-	siano teste ios	1
itur: ita ut in	praesentiarum n	0
 contingere po-	tuisse iure cre	1
rofecto liquet:	quia dei eos pa	0
iu sustinuit ad	pninam: et ira 	0
 thezaurizavere	furoris dei veh	0
 adcrevit ¶ Sed	iuxta allegoria	0
t illa celestis	hierlim quae de	0
sse a domino mo	nilibus adornat	1
ur: plorans plo	rat in nocte in	1
videlicet huius	vite: quia lice	0
estinata sit ad	gloriam superna	0
 tamen adhuc in	ter caligines v	1
ntiae et discri	mina nostrae ce	1
 signantur ait.	Quia profecto n	0
s quae foris to	lerat gemens do	1
pro his erumnis	infirmitatum su	0
is quibus intus	afficitur flend	0
rat ergo ea non	minus quae sent	0
et tolerat exte	rius. Sed prius	1
ibus secretorum	suorum cordium:	0
xterius lachry-	mis interiusue 	1
izatur. De fon-	te quippe intus	1
tus et lachryma	quae foris prod	0
cclesia plorans	plorare dominu:	0
dio gaudere. et	vita vivere: qu	0
i maius aliquid	est significant	0
ivere et gaudio	gaudere quam si	0
gaudere et vive	re: ita maius e	1
ns ploravit di-	cere: ut uberta	1
erfecte compun-	ctionis interiu	1
tiam demonstret	lacrimarum exte	0
tinus non minus	exterior quam e	0
omo ad integrum	reformatus ablu	0
iligentius sive	iusti sive pecc	0
rti utilis psal	mus erit. Iusto	1
ligentiam ac de	fidiam obtorpes	0
m ne semetipsum	despiciat. utri	0
tenptio. Cum et	iustus per negl	0
cator cum de se	desperaverit pe	0
te in ruina per	maneat neque il	1
dicet prophetae	grandae peccatu	0
eroget de nobis	dei eius miserc	0
tiam faciens et	bonus gesta sci	0
ntiam in melius	commutavit ut a	0
provideant sani	tatem et iusti 	1
ccatori stabili	or portus. Quon	1
eccasse et peni	tuisse non desp	1
e. et cum audio	diabolum de cae	0
mei sit occasio	resurgendi prop	0
 non solum bene	gesta scientiam	0
ravit. Non enim	propter illos t	0
r illos qui for	te simili passi	1
lo ergo ostende	re. hunc fortis	1
m lapsum victum	surgentem pumgn	0
. et conronatum	Nec ein ostendo	0
t iacentem. sed	exurgentem ut e	0
ucrum sit et si	forte peccaveri	0
d curras illico	ad surgendum. n	0
 persona petens	licite potuit p	0
si discrete vel	minus discrete 	0
o videndum quid	persona inpende	0
ttere. et se ob	ligare 30 quant	1
sum suffragium.	Et an solum uni	0
ari aliis exclu	sis. quarto ad 	1
io tam petentis	quam deferentis	0
artari Primo ex	clusam esse vol	1
acam pravitatem	per conventione	0
amlibet contrac	tum illicitum i	1
servata pia con	suetudine et sp	1
o sustentatione	ministrantis. E	0
terius est spe-	culationis et c	1
ntem suffragium	sive vivum sive	0
 fuit pro anime	suae caeleriori	0
rgatorii. et sa	tisfactione suo	1
 ut sacrifitium	altaris offerre	0
ollectae in sin	gulari seu in p	1
 nullo ecclesia	stico doctore r	1
 devotionem pe-	tentium aliis s	1
a fieri possent	et deberent. tu	0
cta fidelium Et	superflue cennt	0
 et benefactori	bus pro fratrib	1
od nullus aude-	bit dicere et o	1
c residet. quot	orines et missa	0
 ad expiationem	pene satisfacto	0
npensationis in	quo consideratu	0
ommutative plus	valem uni quam 	0
intentionem fa-	cientis et pete	1
in scripto quar	A iii   0
rtare tamen vi-	tem cum fructu 	1
i intra sanctam	ecclesiam quamv	0
non habeant dum	tamen sanctos v	1
tualibus plenos	sustentant. qui	0
 cum botris por	tant. Tertium a	1
est ut alio tem	pore quando ces	1
plicandi se ne-	gotiis sanctura	1
ivinis ut sic a	lio tempore rec	1
empore videntur	minus fecisse. 	0
um legimus Numi	ix. de quibusda	0
d moysen qui di	xerunt. immundi	1
 animam hominis	quare fraudamur	0
amus oblationem	ferre domino in	0
ter filios isra	ihel. Et sequit	1
nsilio domni ut	alio tempore re	0
 facere non po-	tuerunt tempore	1
iter in proposi	ito. Quartum re	1
urgant tanto ma	nius et audiant	1
ando festum est	sollemnae si op	0
i non satisfaci	unt ad totum sa	1
ensent per haec	enim et similia	0
nis conscientia	ne contraveniat	0
elebrari ferias	aut festa igitu	0
pso est paratus	sit confiteri. 	0
e. et utrum ha-	beat bonam volu	1
cata et servien	di deo Et an fa	1
entiam suam pro	opportunitate l	0
. Quandium enim	quis in istis d	0
et accedere. De	inde probet an 	1
in aliquo gravi	peccato. de quo	0
oleat. adhuc ta	men affectus su	1
gatus. sed occu	pata sit fantas	1
tionibus ac com	motionibus prae	1
oluntatem gravi	ter inquinata E	1
s vehementur im	pediat spiritum	1
cionem non ser-	viat. sed rebel	1
per Canon sermo	ne iii. Recenti	1
lvere ora sacra	continges. Haer	0
odie vultui glo	riae praesentar	1
habeat ex culpa	vel neglegentia	0
is impedimentum	utpote pollutio	0
agnam distracti	onem animi ¶ Po	1
sit nimis indis	positus ad omne	1
 praeter culpam	et neglegentiam	0
set gravatus ca	pite. praessus 	1
imium taediosus	Haec enim sunt 	0
ne est abstinen	dum quandocumqu	1
 Nam in necessi	tatis articulo 	1
sufficit habere	illa primo desc	0
ita non possunt	haberi Proficie	0
ebet esse omnis	qui saepe autem	0
e proponit. non	sufficiunt haec	0
 sua debet esse	Et beatus antho	0
 vincendi inimi	cum est letitia	1
. de iuda. quod	proeliabatur pr	0
r. quod dilata-	vit gloriam pop	1
plicitur semper	eum affligendo.	0
stimento et ver	mis ligno. sic 	1
et etiam homini	eum excecando i	0
de in vitis pa-	trum legitur. V	1
ursoris. et tri	stitia impedime	1
et etiam tristi	tia spiritualit	1
us peccati occa	sio. Unde eccle	1
le a te. multos	xv. ca. 0
De tedio vitae.	enim occidit tr	0
idit tristitia.	Sequitur de ted	0
v. partinens ad	accidiam. et pr	0
 in differentia	Postquam enim a	0
ulatim corruit.	adeo ut non sol	0
tiam vivere. No	tandum tamen es	1
caus. Quandoque	provenit ex dei	0
. Unde gratiae.	Sancti graviter	0
d amant. Quoque	enim provenit e	0
lenus est. Unde	eccles.ii. Taed	0
rsa esse sub so	le et luna. et 1	
t eiusdem. iiii	Vidi calumnias 	0
ocentium. et ne	minem consolato	1
tiae et cetera.	Quandoque prove	0
 tribulationis.	Unde Iob.x. Ted	0
ad correcti. Su	pra modum grava	1
s etiam vivere.	Quandoque etiam	0
od possumus re-	ferre quod legi	1
i peciit animae	suae ut moreret	0
rum. et obdormi	vit. et ecce an	1
r quibusdam in-	terpositis quod	1
ratione.xvi. c.	Sequitur de des	0
 ultimum vitium	pertinens ad ac	0
